optimize_name,qubit,p_t,input_gates,seed,depth_bef,all_gates,one-qubit_gates,two-qubit gates,t,H,otherRZ,CNOT,CZ,depth_aft,time
phase_no_preaft,4,0.0,10000,1000,5165,10000,6648,3352,0,3316,3332,3352,0,5165,2.305968999862671
phase_no_preaft,4,0.0,10000,1001,5125,10000,6701,3299,0,3405,3296,3299,0,5125,2.2377493381500244
phase_no_preaft,4,0.0,10000,1002,5119,10000,6716,3284,0,3337,3379,3284,0,5119,2.3020782470703125
phase_no_preaft,4,0.0,10000,1003,5135,10000,6669,3331,0,3256,3413,3331,0,5135,2.5097532272338867
phase_no_preaft,4,0.0,10000,1004,5090,10000,6797,3203,0,3439,3358,3203,0,5090,2.173023223876953
phase_no_preaft,4,0.04,10000,1000,5091,9963,6753,3210,329,3176,3248,3210,0,5080,2.4712753295898438
phase_no_preaft,4,0.04,10000,1001,5053,9964,6784,3180,350,3275,3159,3180,0,5050,2.3022074699401855
phase_no_preaft,4,0.04,10000,1002,5039,9972,6822,3150,342,3221,3259,3150,0,5028,2.353060722351074
phase_no_preaft,4,0.04,10000,1003,5069,9964,6764,3200,308,3137,3319,3200,0,5056,2.4302163124084473
phase_no_preaft,4,0.04,10000,1004,5001,9972,6901,3071,338,3324,3239,3071,0,4992,2.4997386932373047
phase_no_preaft,4,0.08,10000,1000,5011,9901,6833,3068,574,3017,3242,3068,0,4977,2.4888386726379395
phase_no_preaft,4,0.08,10000,1001,4980,9897,6853,3044,610,3155,3088,3044,0,4946,2.5220489501953125
phase_no_preaft,4,0.08,10000,1002,4967,9895,6873,3022,609,3078,3186,3022,0,4935,2.4918863773345947
phase_no_preaft,4,0.08,10000,1003,4998,9872,6813,3059,563,3009,3241,3059,0,4951,2.381593704223633
phase_no_preaft,4,0.08,10000,1004,4916,9888,6954,2934,586,3199,3169,2934,0,4880,2.35786509513855
phase_no_preaft,4,0.12,10000,1000,4947,9789,6829,2960,733,2897,3199,2960,0,4879,2.5071167945861816
phase_no_preaft,4,0.12,10000,1001,4888,9771,6883,2888,776,3014,3093,2888,0,4816,2.748004198074341
phase_no_preaft,4,0.12,10000,1002,4893,9778,6885,2893,757,2967,3161,2893,0,4825,2.575927734375
phase_no_preaft,4,0.12,10000,1003,4933,9759,6846,2913,757,2872,3217,2913,0,4849,2.3651740550994873
phase_no_preaft,4,0.12,10000,1004,4851,9764,6930,2834,767,3021,3142,2834,0,4783,2.5817136764526367
phase_no_preaft,4,0.16,10000,1000,4857,9652,6841,2811,877,2785,3179,2811,0,4742,2.5001626014709473
phase_no_preaft,4,0.16,10000,1001,4820,9644,6874,2770,928,2900,3046,2770,0,4709,2.36301589012146
phase_no_preaft,4,0.16,10000,1002,4807,9641,6887,2754,902,2839,3146,2754,0,4700,2.4537675380706787
phase_no_preaft,4,0.16,10000,1003,4818,9611,6857,2754,895,2714,3248,2754,0,4684,2.369927167892456
phase_no_preaft,4,0.16,10000,1004,4795,9642,6913,2729,922,2883,3108,2729,0,4676,2.384608507156372
phase_no_preaft,4,0.2,10000,1000,4771,9495,6854,2641,971,2666,3217,2641,0,4596,2.4645018577575684
phase_no_preaft,4,0.2,10000,1001,4731,9498,6869,2629,980,2758,3131,2629,0,4584,2.422663450241089
phase_no_preaft,4,0.2,10000,1002,4743,9494,6855,2639,964,2688,3203,2639,0,4580,2.43743896484375
phase_no_preaft,4,0.2,10000,1003,4761,9463,6832,2631,1008,2573,3251,2631,0,4583,2.5066027641296387
phase_no_preaft,4,0.2,10000,1004,4711,9480,6890,2590,991,2754,3145,2590,0,4538,2.4744534492492676
phase_no_preaft,4,0.24,10000,1000,4693,9326,6815,2511,1039,2543,3233,2511,0,4468,2.526555061340332
phase_no_preaft,4,0.24,10000,1001,4649,9320,6813,2507,1023,2619,3171,2507,0,4438,2.359452724456787
phase_no_preaft,4,0.24,10000,1002,4672,9317,6792,2525,1024,2532,3236,2525,0,4456,2.3871710300445557
phase_no_preaft,4,0.24,10000,1003,4675,9282,6813,2469,1049,2458,3306,2469,0,4437,2.4230196475982666
phase_no_preaft,4,0.24,10000,1004,4637,9309,6838,2471,1036,2613,3189,2471,0,4408,2.3450241088867188
phase_no_preaft,4,0.28,10000,1000,4586,9147,6771,2376,1079,2397,3295,2376,0,4312,2.3519678115844727
phase_no_preaft,4,0.28,10000,1001,4574,9169,6794,2375,1079,2474,3241,2375,0,4310,2.444606065750122
phase_no_preaft,4,0.28,10000,1002,4600,9151,6753,2398,1090,2383,3280,2398,0,4328,2.393362283706665
phase_no_preaft,4,0.28,10000,1003,4585,9113,6780,2333,1105,2336,3339,2333,0,4300,2.3518733978271484
phase_no_preaft,4,0.28,10000,1004,4584,9162,6797,2365,1124,2481,3192,2365,0,4314,2.3888463973999023
phase_no_preaft,4,0.32,10000,1000,4521,8956,6716,2240,1130,2271,3315,2240,0,4195,2.407411575317383
phase_no_preaft,4,0.32,10000,1001,4496,8975,6735,2240,1122,2316,3297,2240,0,4168,2.5261099338531494
phase_no_preaft,4,0.32,10000,1002,4505,8949,6676,2273,1099,2222,3355,2273,0,4177,2.4645040035247803
phase_no_preaft,4,0.32,10000,1003,4516,8943,6728,2215,1156,2217,3355,2215,0,4188,2.4338269233703613
phase_no_preaft,4,0.32,10000,1004,4505,8978,6758,2220,1140,2335,3283,2220,0,4170,2.3327693939208984
phase_no_preaft,4,0.36,10000,1000,4426,8742,6628,2114,1114,2135,3379,2114,0,4027,2.3229122161865234
phase_no_preaft,4,0.36,10000,1001,4391,8793,6700,2093,1148,2185,3367,2093,0,4005,2.3936192989349365
phase_no_preaft,4,0.36,10000,1002,4425,8736,6613,2123,1126,2079,3408,2123,0,4033,2.5326056480407715
phase_no_preaft,4,0.36,10000,1003,4440,8742,6660,2082,1155,2099,3406,2082,0,4042,2.4265377521514893
phase_no_preaft,4,0.36,10000,1004,4424,8783,6685,2098,1143,2207,3335,2098,0,4029,2.3808958530426025
phase_no_preaft,4,0.4,10000,1000,4369,8539,6518,2021,1088,1996,3434,2021,0,3911,2.4048168659210205
phase_no_preaft,4,0.4,10000,1001,4307,8567,6593,1974,1103,2035,3455,1974,0,3861,2.476353168487549
phase_no_preaft,4,0.4,10000,1002,4325,8513,6534,1979,1098,1973,3463,1979,0,3841,2.3740665912628174
phase_no_preaft,4,0.4,10000,1003,4335,8526,6581,1945,1130,1980,3471,1945,0,3854,2.4843053817749023
phase_no_preaft,4,0.4,10000,1004,4342,8586,6611,1975,1110,2063,3438,1975,0,3893,2.326639413833618
phase_no_preaft,8,0.0,10000,1000,3003,10000,6664,3336,0,3327,3337,3336,0,3003,2.795612096786499
phase_no_preaft,8,0.0,10000,1001,2966,10000,6751,3249,0,3421,3330,3249,0,2966,2.7544569969177246
phase_no_preaft,8,0.0,10000,1002,2969,10000,6740,3260,0,3354,3386,3260,0,2969,2.688842535018921
phase_no_preaft,8,0.0,10000,1003,2990,10000,6689,3311,0,3269,3420,3311,0,2990,2.986619472503662
phase_no_preaft,8,0.0,10000,1004,2961,10000,6751,3249,0,3417,3334,3249,0,2961,2.7901153564453125
phase_no_preaft,8,0.04,10000,1000,2931,9970,6792,3178,344,3196,3252,3178,0,2923,3.1325740814208984
phase_no_preaft,8,0.04,10000,1001,2952,9971,6842,3129,357,3284,3201,3129,0,2949,3.1283278465270996
phase_no_preaft,8,0.04,10000,1002,2927,9973,6855,3118,354,3234,3267,3118,0,2924,3.207982301712036
phase_no_preaft,8,0.04,10000,1003,2935,9980,6803,3177,347,3157,3299,3177,0,2932,2.9054019451141357
phase_no_preaft,8,0.04,10000,1004,2892,9977,6874,3103,367,3296,3211,3103,0,2889,3.1903038024902344
phase_no_preaft,8,0.08,10000,1000,2872,9909,6862,3047,589,3046,3227,3047,0,2860,2.863987445831299
phase_no_preaft,8,0.08,10000,1001,2893,9896,6906,2990,605,3160,3141,2990,0,2879,2.873854160308838
phase_no_preaft,8,0.08,10000,1002,2878,9898,6899,2999,623,3079,3197,2999,0,2856,2.907259464263916
phase_no_preaft,8,0.08,10000,1003,2885,9887,6829,3058,585,3026,3218,3058,0,2870,2.896493673324585
phase_no_preaft,8,0.08,10000,1004,2831,9900,6948,2952,635,3182,3131,2952,0,2816,2.750814437866211
phase_no_preaft,8,0.12,10000,1000,2826,9805,6864,2941,756,2915,3193,2941,0,2799,2.788378953933716
phase_no_preaft,8,0.12,10000,1001,2847,9795,6938,2857,802,3028,3108,2857,0,2816,2.7244441509246826
phase_no_preaft,8,0.12,10000,1002,2804,9786,6930,2856,792,2973,3165,2856,0,2763,2.700582981109619
phase_no_preaft,8,0.12,10000,1003,2829,9770,6867,2903,765,2899,3203,2903,0,2792,2.6836049556732178
phase_no_preaft,8,0.12,10000,1004,2787,9788,6948,2840,834,3018,3096,2840,0,2757,2.7394471168518066
phase_no_preaft,8,0.16,10000,1000,2767,9674,6863,2811,904,2795,3164,2811,0,2718,2.63497257232666
phase_no_preaft,8,0.16,10000,1001,2779,9663,6927,2736,954,2914,3059,2736,0,2736,2.686314821243286
phase_no_preaft,8,0.16,10000,1002,2755,9653,6944,2709,934,2839,3171,2709,0,2690,2.6463301181793213
phase_no_preaft,8,0.16,10000,1003,2775,9627,6874,2753,912,2741,3221,2753,0,2722,2.7116196155548096
phase_no_preaft,8,0.16,10000,1004,2725,9659,6927,2732,962,2884,3081,2732,0,2676,2.694981336593628
phase_no_preaft,8,0.2,10000,1000,2707,9521,6867,2654,995,2670,3202,2654,0,2635,2.7068281173706055
phase_no_preaft,8,0.2,10000,1001,2727,9539,6931,2608,1051,2759,3121,2608,0,2666,2.6615092754364014
phase_no_preaft,8,0.2,10000,1002,2715,9522,6915,2607,1032,2685,3198,2607,0,2634,2.7458913326263428
phase_no_preaft,8,0.2,10000,1003,2718,9488,6858,2630,1031,2597,3230,2630,0,2646,2.7114691734313965
phase_no_preaft,8,0.2,10000,1004,2669,9506,6904,2602,1028,2764,3112,2602,0,2597,2.7569737434387207
phase_no_preaft,8,0.24,10000,1000,2654,9353,6835,2518,1063,2547,3225,2518,0,2548,2.705183506011963
phase_no_preaft,8,0.24,10000,1001,2663,9366,6885,2481,1124,2613,3148,2481,0,2563,2.531682252883911
phase_no_preaft,8,0.24,10000,1002,2646,9357,6852,2505,1115,2530,3207,2505,0,2551,2.5218100547790527
phase_no_preaft,8,0.24,10000,1003,2647,9325,6847,2478,1100,2470,3277,2478,0,2551,2.546165704727173
phase_no_preaft,8,0.24,10000,1004,2634,9338,6851,2487,1083,2616,3152,2487,0,2532,2.658027410507202
phase_no_preaft,8,0.28,10000,1000,2588,9206,6838,2368,1160,2407,3271,2368,0,2456,2.47676682472229
phase_no_preaft,8,0.28,10000,1001,2612,9220,6861,2359,1172,2462,3227,2359,0,2493,2.4568393230438232
phase_no_preaft,8,0.28,10000,1002,2608,9173,6794,2379,1151,2379,3264,2379,0,2479,2.5646283626556396
phase_no_preaft,8,0.28,10000,1003,2591,9169,6822,2347,1175,2338,3309,2347,0,2473,2.651165723800659
phase_no_preaft,8,0.28,10000,1004,2592,9152,6778,2374,1086,2480,3212,2374,0,2458,2.6818490028381348
phase_no_preaft,8,0.32,10000,1000,2525,8982,6748,2234,1170,2273,3305,2234,0,2363,2.6525957584381104
phase_no_preaft,8,0.32,10000,1001,2536,9016,6792,2224,1184,2311,3297,2224,0,2397,2.4910173416137695
phase_no_preaft,8,0.32,10000,1002,2557,8980,6725,2255,1168,2219,3338,2255,0,2389,2.533202648162842
phase_no_preaft,8,0.32,10000,1003,2549,9000,6776,2224,1251,2208,3317,2224,0,2417,2.594128370285034
phase_no_preaft,8,0.32,10000,1004,2526,8970,6736,2234,1106,2342,3288,2234,0,2356,2.635514259338379
phase_no_preaft,8,0.36,10000,1000,2480,8774,6668,2106,1163,2136,3369,2106,0,2271,2.720533847808838
phase_no_preaft,8,0.36,10000,1001,2474,8816,6721,2095,1168,2170,3383,2095,0,2283,2.5555241107940674
phase_no_preaft,8,0.36,10000,1002,2477,8762,6661,2101,1189,2076,3396,2101,0,2275,2.585899829864502
phase_no_preaft,8,0.36,10000,1003,2474,8777,6707,2070,1217,2094,3396,2070,0,2313,2.5510382652282715
phase_no_preaft,8,0.36,10000,1004,2486,8777,6673,2104,1128,2205,3340,2104,0,2278,2.5841000080108643
phase_no_preaft,8,0.4,10000,1000,2441,8579,6576,2003,1171,2001,3404,2003,0,2215,2.528615951538086
phase_no_preaft,8,0.4,10000,1001,2437,8587,6619,1968,1142,2035,3442,1968,0,2214,2.590191125869751
phase_no_preaft,8,0.4,10000,1002,2423,8528,6577,1951,1135,1973,3469,1951,0,2192,2.4653000831604004
phase_no_preaft,8,0.4,10000,1003,2407,8598,6650,1948,1237,1972,3441,1948,0,2218,2.600308895111084
phase_no_preaft,8,0.4,10000,1004,2431,8630,6654,1976,1175,2057,3422,1976,0,2211,2.5949058532714844
phase_no_preaft,12,0.0,10000,1000,2131,10000,6634,3366,0,3347,3287,3366,0,2131,4.014341831207275
phase_no_preaft,12,0.0,10000,1001,2140,10000,6641,3359,0,3403,3238,3359,0,2140,4.9517762660980225
phase_no_preaft,12,0.0,10000,1002,2167,10000,6633,3367,0,3320,3313,3367,0,2167,3.9999887943267822
phase_no_preaft,12,0.0,10000,1003,2150,10000,6697,3303,0,3304,3393,3303,0,2150,4.584266185760498
phase_no_preaft,12,0.0,10000,1004,2065,10000,6782,3218,0,3474,3308,3218,0,2065,3.9847211837768555
phase_no_preaft,12,0.04,10000,1000,2098,9981,6746,3235,352,3228,3166,3235,0,2097,5.349642515182495
phase_no_preaft,12,0.04,10000,1001,2086,9969,6793,3176,351,3277,3165,3176,0,2080,6.23769211769104
phase_no_preaft,12,0.04,10000,1002,2093,9963,6767,3196,332,3199,3236,3196,0,2088,6.647505760192871
phase_no_preaft,12,0.04,10000,1003,2113,9974,6765,3209,309,3146,3310,3209,0,2111,5.093810796737671
phase_no_preaft,12,0.04,10000,1004,2025,9979,6878,3101,353,3346,3179,3101,0,2024,4.83480429649353
phase_no_preaft,12,0.08,10000,1000,2048,9913,6823,3090,619,3090,3114,3090,0,2042,4.164247751235962
phase_no_preaft,12,0.08,10000,1001,2049,9902,6849,3053,615,3143,3091,3053,0,2037,3.7739899158477783
phase_no_preaft,12,0.08,10000,1002,2050,9890,6826,3064,597,3075,3154,3064,0,2041,5.463464021682739
phase_no_preaft,12,0.08,10000,1003,2068,9895,6820,3075,576,3011,3233,3075,0,2060,4.91548752784729
phase_no_preaft,12,0.08,10000,1004,2010,9917,6928,2989,608,3204,3116,2989,0,2005,4.4345691204071045
phase_no_preaft,12,0.12,10000,1000,2020,9826,6857,2969,806,2937,3114,2969,0,2007,3.5545527935028076
phase_no_preaft,12,0.12,10000,1001,1988,9800,6939,2861,825,3019,3095,2861,0,1963,3.6610660552978516
phase_no_preaft,12,0.12,10000,1002,2000,9785,6868,2917,814,2940,3114,2917,0,1973,3.27115797996521
phase_no_preaft,12,0.12,10000,1003,2017,9807,6879,2928,818,2917,3144,2928,0,2000,3.404226064682007
phase_no_preaft,12,0.12,10000,1004,1982,9808,6928,2880,775,3047,3106,2880,0,1963,3.7483410835266113
phase_no_preaft,12,0.16,10000,1000,1986,9700,6861,2839,974,2810,3077,2839,0,1958,3.438250780105591
phase_no_preaft,12,0.16,10000,1001,1914,9676,6954,2722,958,2852,3144,2722,0,1878,3.18436336517334
phase_no_preaft,12,0.16,10000,1002,1961,9643,6863,2780,949,2782,3132,2780,0,1924,3.2788214683532715
phase_no_preaft,12,0.16,10000,1003,1984,9660,6880,2780,942,2804,3134,2780,0,1954,3.1874139308929443
phase_no_preaft,12,0.16,10000,1004,1918,9666,6915,2751,938,2907,3070,2751,0,1890,3.1414237022399902
phase_no_preaft,12,0.2,10000,1000,1928,9540,6868,2672,1083,2692,3093,2672,0,1885,3.063493251800537
phase_no_preaft,12,0.2,10000,1001,1901,9530,6925,2605,1038,2723,3164,2605,0,1846,2.8784539699554443
phase_no_preaft,12,0.2,10000,1002,1926,9489,6847,2642,1029,2647,3171,2642,0,1868,3.0154056549072266
phase_no_preaft,12,0.2,10000,1003,1948,9508,6866,2642,1043,2662,3161,2642,0,1896,2.9706263542175293
phase_no_preaft,12,0.2,10000,1004,1880,9540,6915,2625,1025,2824,3066,2625,0,1840,2.9992830753326416
phase_no_preaft,12,0.24,10000,1000,1884,9361,6843,2518,1134,2555,3154,2518,0,1823,2.7435576915740967
phase_no_preaft,12,0.24,10000,1001,1872,9353,6890,2463,1095,2602,3193,2463,0,1801,2.795860767364502
phase_no_preaft,12,0.24,10000,1002,1887,9318,6792,2526,1081,2502,3209,2526,0,1807,2.827073812484741
phase_no_preaft,12,0.24,10000,1003,1890,9331,6827,2504,1097,2527,3203,2504,0,1821,2.743980884552002
phase_no_preaft,12,0.24,10000,1004,1851,9366,6890,2476,1087,2689,3114,2476,0,1795,2.8020732402801514
phase_no_preaft,12,0.28,10000,1000,1840,9201,6810,2391,1196,2439,3175,2391,0,1764,2.689373731613159
phase_no_preaft,12,0.28,10000,1001,1823,9194,6834,2360,1175,2445,3214,2360,0,1739,2.756044864654541
phase_no_preaft,12,0.28,10000,1002,1849,9153,6746,2407,1157,2374,3215,2407,0,1753,3.0082485675811768
phase_no_preaft,12,0.28,10000,1003,1849,9165,6757,2408,1143,2370,3244,2408,0,1767,2.8062472343444824
phase_no_preaft,12,0.28,10000,1004,1813,9197,6841,2356,1143,2576,3122,2356,0,1733,2.851172685623169
phase_no_preaft,12,0.32,10000,1000,1790,8980,6734,2246,1191,2292,3251,2246,0,1680,2.9096803665161133
phase_no_preaft,12,0.32,10000,1001,1779,9003,6777,2226,1207,2285,3285,2226,0,1660,2.7206149101257324
phase_no_preaft,12,0.32,10000,1002,1808,8960,6700,2260,1158,2230,3312,2260,0,1691,3.0132739543914795
phase_no_preaft,12,0.32,10000,1003,1786,8987,6688,2299,1212,2219,3257,2299,0,1692,2.912069082260132
phase_no_preaft,12,0.32,10000,1004,1788,9057,6793,2264,1224,2432,3137,2264,0,1694,2.6662673950195312
phase_no_preaft,12,0.36,10000,1000,1738,8770,6667,2103,1173,2156,3338,2103,0,1618,2.719883918762207
phase_no_preaft,12,0.36,10000,1001,1719,8805,6735,2070,1199,2139,3397,2070,0,1571,2.7623655796051025
phase_no_preaft,12,0.36,10000,1002,1752,8770,6645,2125,1177,2094,3374,2125,0,1622,2.746791362762451
phase_no_preaft,12,0.36,10000,1003,1763,8797,6644,2153,1246,2078,3320,2153,0,1638,2.7789649963378906
phase_no_preaft,12,0.36,10000,1004,1751,8866,6743,2123,1230,2281,3232,2123,0,1633,2.6785995960235596
phase_no_preaft,12,0.4,10000,1000,1713,8576,6604,1972,1174,2026,3404,1972,0,1564,2.541578531265259
phase_no_preaft,12,0.4,10000,1001,1671,8591,6661,1930,1173,1990,3498,1930,0,1509,2.558309316635132
phase_no_preaft,12,0.4,10000,1002,1705,8535,6579,1956,1165,1990,3424,1956,0,1551,2.652050256729126
phase_no_preaft,12,0.4,10000,1003,1715,8583,6556,2027,1216,1957,3383,2027,0,1573,2.6849451065063477
phase_no_preaft,12,0.4,10000,1004,1720,8691,6692,1999,1205,2112,3375,1999,0,1588,2.5476248264312744
phase_no_preaft,16,0.0,10000,1000,1703,10000,6667,3333,0,3330,3337,3333,0,1703,5.324266195297241
phase_no_preaft,16,0.0,10000,1001,1633,10000,6754,3246,0,3419,3335,3246,0,1633,5.623624086380005
phase_no_preaft,16,0.0,10000,1002,1640,10000,6739,3261,0,3350,3389,3261,0,1640,4.5920586585998535
phase_no_preaft,16,0.0,10000,1003,1665,10000,6694,3306,0,3295,3399,3306,0,1665,5.372107982635498
phase_no_preaft,16,0.0,10000,1004,1669,10000,6773,3227,0,3420,3353,3227,0,1669,6.489214897155762
phase_no_preaft,16,0.04,10000,1000,1654,9969,6788,3181,347,3198,3243,3181,0,1652,8.518898248672485
phase_no_preaft,16,0.04,10000,1001,1615,9972,6843,3129,364,3263,3216,3129,0,1613,11.80769157409668
phase_no_preaft,16,0.04,10000,1002,1601,9977,6865,3112,366,3238,3261,3112,0,1600,9.097103118896484
phase_no_preaft,16,0.04,10000,1003,1647,9976,6804,3172,338,3188,3278,3172,0,1644,8.252077102661133
phase_no_preaft,16,0.04,10000,1004,1631,9971,6895,3076,368,3306,3221,3076,0,1631,11.791095972061157
phase_no_preaft,16,0.08,10000,1000,1633,9911,6867,3044,600,3036,3231,3044,0,1626,6.068296670913696
phase_no_preaft,16,0.08,10000,1001,1597,9907,6923,2984,617,3142,3164,2984,0,1588,7.798335552215576
phase_no_preaft,16,0.08,10000,1002,1583,9914,6918,2996,640,3094,3184,2996,0,1577,6.642465114593506
phase_no_preaft,16,0.08,10000,1003,1608,9896,6849,3047,605,3059,3185,3047,0,1601,6.516718149185181
phase_no_preaft,16,0.08,10000,1004,1568,9887,6957,2930,619,3178,3160,2930,0,1563,7.152523040771484
phase_no_preaft,16,0.12,10000,1000,1595,9817,6886,2931,799,2910,3177,2931,0,1584,5.029973030090332
phase_no_preaft,16,0.12,10000,1001,1567,9809,6958,2851,824,3000,3134,2851,0,1556,4.4929139614105225
phase_no_preaft,16,0.12,10000,1002,1562,9803,6927,2876,793,2973,3161,2876,0,1542,5.595527410507202
phase_no_preaft,16,0.12,10000,1003,1554,9785,6892,2893,807,2921,3164,2893,0,1538,4.4093663692474365
phase_no_preaft,16,0.12,10000,1004,1544,9771,6947,2824,808,3018,3121,2824,0,1535,4.210202693939209
phase_no_preaft,16,0.16,10000,1000,1562,9692,6881,2811,949,2797,3135,2811,0,1540,3.737962484359741
phase_no_preaft,16,0.16,10000,1001,1537,9668,6932,2736,956,2872,3104,2736,0,1514,3.9443233013153076
phase_no_preaft,16,0.16,10000,1002,1530,9665,6940,2725,945,2834,3161,2725,0,1505,4.251437425613403
phase_no_preaft,16,0.16,10000,1003,1509,9657,6915,2742,964,2756,3195,2742,0,1477,3.8506715297698975
phase_no_preaft,16,0.16,10000,1004,1517,9659,6945,2714,969,2888,3088,2714,0,1492,3.9539153575897217
phase_no_preaft,16,0.2,10000,1000,1533,9537,6889,2648,1038,2672,3179,2648,0,1503,3.2940778732299805
phase_no_preaft,16,0.2,10000,1001,1508,9536,6938,2598,1057,2730,3151,2598,0,1470,3.6142354011535645
phase_no_preaft,16,0.2,10000,1002,1502,9531,6911,2620,1031,2687,3193,2620,0,1473,3.5118651390075684
phase_no_preaft,16,0.2,10000,1003,1500,9510,6896,2614,1063,2616,3217,2614,0,1464,3.7198898792266846
phase_no_preaft,16,0.2,10000,1004,1490,9519,6939,2580,1064,2767,3108,2580,0,1454,3.4074676036834717
phase_no_preaft,16,0.24,10000,1000,1506,9375,6854,2521,1117,2542,3195,2521,0,1455,3.1917595863342285
phase_no_preaft,16,0.24,10000,1001,1454,9376,6895,2481,1140,2589,3166,2481,0,1402,3.324190378189087
phase_no_preaft,16,0.24,10000,1002,1483,9355,6847,2508,1095,2535,3217,2508,0,1439,3.2320075035095215
phase_no_preaft,16,0.24,10000,1003,1463,9329,6870,2459,1112,2487,3271,2459,0,1412,3.413139820098877
phase_no_preaft,16,0.24,10000,1004,1479,9380,6912,2468,1155,2625,3132,2468,0,1427,3.221041202545166
phase_no_preaft,16,0.28,10000,1000,1458,9194,6825,2369,1157,2405,3263,2369,0,1399,3.078099489212036
phase_no_preaft,16,0.28,10000,1001,1432,9229,6873,2356,1189,2449,3235,2356,0,1372,2.9675183296203613
phase_no_preaft,16,0.28,10000,1002,1428,9193,6819,2374,1171,2389,3259,2374,0,1372,3.1555721759796143
phase_no_preaft,16,0.28,10000,1003,1414,9157,6825,2332,1147,2352,3326,2332,0,1349,3.4114623069763184
phase_no_preaft,16,0.28,10000,1004,1444,9203,6847,2356,1174,2483,3190,2356,0,1370,3.0795445442199707
phase_no_preaft,16,0.32,10000,1000,1408,8996,6766,2230,1225,2268,3273,2230,0,1344,3.0018160343170166
phase_no_preaft,16,0.32,10000,1001,1394,9035,6816,2219,1226,2303,3287,2219,0,1317,2.8265793323516846
phase_no_preaft,16,0.32,10000,1002,1403,8998,6752,2246,1196,2224,3332,2246,0,1325,3.005906343460083
phase_no_preaft,16,0.32,10000,1003,1393,8969,6769,2200,1183,2214,3372,2200,0,1319,3.105149030685425
phase_no_preaft,16,0.32,10000,1004,1405,9003,6785,2218,1188,2334,3263,2218,0,1314,3.028144359588623
phase_no_preaft,16,0.36,10000,1000,1366,8793,6692,2101,1217,2132,3343,2101,0,1279,2.8812785148620605
phase_no_preaft,16,0.36,10000,1001,1356,8828,6744,2084,1200,2168,3376,2084,0,1263,2.849822521209717
phase_no_preaft,16,0.36,10000,1002,1368,8765,6673,2092,1195,2082,3396,2092,0,1273,2.6698176860809326
phase_no_preaft,16,0.36,10000,1003,1360,8794,6730,2064,1231,2094,3405,2064,0,1276,2.7499687671661377
phase_no_preaft,16,0.36,10000,1004,1356,8815,6718,2097,1220,2198,3300,2097,0,1256,2.714752674102783
phase_no_preaft,16,0.4,10000,1000,1327,8598,6599,1999,1233,1996,3370,1999,0,1220,2.846031427383423
phase_no_preaft,16,0.4,10000,1001,1326,8599,6647,1952,1182,2031,3434,1952,0,1209,2.7218129634857178
phase_no_preaft,16,0.4,10000,1002,1329,8578,6632,1946,1224,1977,3431,1946,0,1225,2.7141473293304443
phase_no_preaft,16,0.4,10000,1003,1326,8574,6635,1939,1210,1967,3458,1939,0,1205,2.8798470497131348
phase_no_preaft,16,0.4,10000,1004,1326,8641,6673,1968,1222,2053,3398,1968,0,1220,2.6420562267303467
