optimize_name,qubit,p_t,input_gates,seed,depth_bef,all_gates,one-qubit_gates,two-qubit gates,t,H,otherRZ,CNOT,CZ,depth_aft,time
phase_full,4,0.0,10000,1000,5165,1880,907,973,0,349,558,776,197,1260,3.89357852935791
phase_full,4,0.0,10000,1001,5125,1895,909,986,0,355,554,781,205,1254,4.4942615032196045
phase_full,4,0.0,10000,1002,5119,1814,836,978,0,329,507,772,206,1217,5.897325754165649
phase_full,4,0.0,10000,1003,5135,1823,869,954,0,347,522,755,199,1205,6.191803455352783
phase_full,4,0.0,10000,1004,5090,1980,934,1046,0,363,571,827,219,1303,7.865337610244751
phase_full,4,0.04,10000,1000,5091,2962,1506,1456,329,570,607,1186,270,1978,10.154003620147705
phase_full,4,0.04,10000,1001,5053,2934,1496,1438,350,575,571,1175,263,1966,12.08194613456726
phase_full,4,0.04,10000,1002,5039,3038,1523,1515,342,581,600,1246,269,2010,6.010730028152466
phase_full,4,0.04,10000,1003,5069,2792,1394,1398,308,539,547,1130,268,1874,5.335028409957886
phase_full,4,0.04,10000,1004,5001,3085,1566,1519,338,597,631,1250,269,2101,6.880026578903198
phase_full,4,0.08,10000,1000,5011,3798,1966,1832,574,732,660,1526,306,2553,5.912743806838989
phase_full,4,0.08,10000,1001,4980,3909,1965,1944,610,743,612,1611,333,2643,6.541682243347168
phase_full,4,0.08,10000,1002,4967,3854,1975,1879,609,731,635,1591,288,2606,6.463658094406128
phase_full,4,0.08,10000,1003,4998,3789,1895,1894,563,722,610,1560,334,2577,6.082219362258911
phase_full,4,0.08,10000,1004,4916,3738,1893,1845,586,723,584,1519,326,2565,6.620446681976318
phase_full,4,0.12,10000,1000,4947,4374,2242,2132,733,838,671,1767,365,2964,7.068609237670898
phase_full,4,0.12,10000,1001,4888,4373,2242,2131,776,842,624,1761,370,2964,7.781867504119873
phase_full,4,0.12,10000,1002,4893,4219,2204,2015,757,833,614,1693,322,2892,7.746227979660034
phase_full,4,0.12,10000,1003,4933,4370,2247,2123,757,847,643,1768,355,2912,8.314683675765991
phase_full,4,0.12,10000,1004,4851,4296,2255,2041,767,853,635,1737,304,2915,8.365731239318848
phase_full,4,0.16,10000,1000,4857,4715,2428,2287,877,887,664,1914,373,3216,8.479761123657227
phase_full,4,0.16,10000,1001,4820,4768,2463,2305,928,937,598,1943,362,3277,9.163638591766357
phase_full,4,0.16,10000,1002,4807,4719,2433,2286,902,917,614,1924,362,3260,8.967033863067627
phase_full,4,0.16,10000,1003,4818,4634,2409,2225,894,878,637,1891,334,3181,8.477319955825806
phase_full,4,0.16,10000,1004,4795,4832,2523,2309,922,941,660,1936,373,3254,9.432243347167969
phase_full,4,0.2,10000,1000,4771,4861,2567,2294,971,944,652,1948,346,3308,9.78746509552002
phase_full,4,0.2,10000,1001,4731,4966,2598,2368,979,965,654,1961,407,3368,10.150146722793579
phase_full,4,0.2,10000,1002,4743,4830,2509,2321,964,937,608,1949,372,3253,9.81320309638977
phase_full,4,0.2,10000,1003,4761,4875,2586,2289,1008,962,616,1929,360,3302,10.652504682540894
phase_full,4,0.2,10000,1004,4711,4906,2562,2344,991,943,628,1979,365,3348,10.817010641098022
phase_full,4,0.24,10000,1000,4693,4991,2625,2366,1039,981,605,2011,355,3404,11.027807712554932
phase_full,4,0.24,10000,1001,4649,5042,2641,2401,1022,966,653,1981,420,3403,11.314680576324463
phase_full,4,0.24,10000,1002,4672,5088,2688,2400,1024,999,665,2042,358,3442,11.483142375946045
phase_full,4,0.24,10000,1003,4675,4982,2604,2378,1049,969,586,2011,367,3404,11.86997938156128
phase_full,4,0.24,10000,1004,4637,4968,2631,2337,1036,984,611,1970,367,3375,12.575740575790405
phase_full,4,0.28,10000,1000,4586,5131,2674,2457,1079,983,612,2095,362,3519,12.745027303695679
phase_full,4,0.28,10000,1001,4574,4966,2648,2318,1079,975,594,1959,359,3368,12.728934049606323
phase_full,4,0.28,10000,1002,4600,4947,2643,2304,1089,975,579,1953,351,3333,13.037955522537231
phase_full,4,0.28,10000,1003,4585,5050,2699,2351,1105,997,597,1979,372,3361,13.577004432678223
phase_full,4,0.28,10000,1004,4584,5157,2718,2439,1124,999,595,2075,364,3516,13.3205406665802
phase_full,4,0.32,10000,1000,4521,5184,2739,2445,1130,1007,602,2058,387,3539,14.808397054672241
phase_full,4,0.32,10000,1001,4496,5016,2646,2370,1122,976,548,1978,392,3417,14.521981000900269
phase_full,4,0.32,10000,1002,4505,5091,2715,2376,1099,994,622,2020,356,3448,15.3869047164917
phase_full,4,0.32,10000,1003,4516,5139,2741,2398,1156,1006,579,2006,392,3474,15.172914028167725
phase_full,4,0.32,10000,1004,4505,5115,2722,2393,1139,999,584,2008,385,3427,14.746108055114746
phase_full,4,0.36,10000,1000,4426,4950,2604,2346,1114,960,530,1970,376,3373,15.711278676986694
phase_full,4,0.36,10000,1001,4391,4880,2622,2258,1148,963,511,1945,313,3238,16.82202172279358
phase_full,4,0.36,10000,1002,4425,5044,2663,2381,1126,973,564,2010,371,3432,16.856016874313354
phase_full,4,0.36,10000,1003,4440,5058,2697,2361,1155,985,557,2003,358,3426,16.570957899093628
phase_full,4,0.36,10000,1004,4424,5061,2687,2374,1143,989,555,2008,366,3394,16.636558771133423
phase_full,4,0.4,10000,1000,4369,4901,2593,2308,1088,952,553,1959,349,3277,17.64300274848938
phase_full,4,0.4,10000,1001,4307,4783,2553,2230,1103,935,515,1866,364,3224,15.83765959739685
phase_full,4,0.4,10000,1002,4325,4793,2552,2241,1097,932,523,1893,348,3214,17.299571990966797
phase_full,4,0.4,10000,1003,4335,4867,2586,2281,1127,945,514,1928,353,3263,17.6030855178833
phase_full,4,0.4,10000,1004,4342,4863,2620,2243,1109,966,545,1907,336,3224,17.960780143737793
phase_full,8,0.0,10000,1000,3003,7134,2059,5075,0,733,1326,3646,1429,3820,17.723386526107788
phase_full,8,0.0,10000,1001,2966,6972,2031,4941,0,729,1302,3485,1456,3748,19.289286375045776
phase_full,8,0.0,10000,1002,2969,7172,2030,5142,0,731,1299,3630,1512,3808,18.332138538360596
phase_full,8,0.0,10000,1003,2990,7053,2024,5029,0,690,1334,3614,1415,3687,19.156912088394165
phase_full,8,0.0,10000,1004,2961,6772,1961,4811,0,687,1274,3414,1397,3580,19.559878826141357
phase_full,8,0.04,10000,1000,2931,8429,2456,5973,344,832,1280,4312,1661,4598,22.92819380760193
phase_full,8,0.04,10000,1001,2952,8338,2576,5762,357,856,1363,4267,1495,4582,24.74314594268799
phase_full,8,0.04,10000,1002,2927,8245,2477,5768,354,836,1287,4219,1549,4493,24.556784629821777
phase_full,8,0.04,10000,1003,2935,8328,2422,5906,347,777,1298,4327,1579,4642,24.028804302215576
phase_full,8,0.04,10000,1004,2892,8171,2461,5710,367,818,1276,4188,1522,4442,24.908740758895874
phase_full,8,0.08,10000,1000,2872,8840,2771,6069,589,911,1271,4533,1536,4939,30.734939575195312
phase_full,8,0.08,10000,1001,2893,8958,2799,6159,605,955,1239,4565,1594,5036,31.031961679458618
phase_full,8,0.08,10000,1002,2878,9350,2890,6460,623,938,1329,4872,1588,5190,32.78110980987549
phase_full,8,0.08,10000,1003,2885,8765,2664,6101,585,877,1202,4496,1605,4842,31.74027991294861
phase_full,8,0.08,10000,1004,2831,9018,2804,6214,635,930,1239,4662,1552,5092,33.8817720413208
phase_full,8,0.12,10000,1000,2826,9385,2934,6451,756,966,1212,4820,1631,5144,38.89498329162598
phase_full,8,0.12,10000,1001,2847,9490,2990,6500,802,997,1191,4841,1659,5319,40.887736558914185
phase_full,8,0.12,10000,1002,2804,9604,3062,6542,792,993,1277,4904,1638,5353,42.787092447280884
phase_full,8,0.12,10000,1003,2829,9232,2920,6312,765,907,1248,4770,1542,5142,40.77864122390747
phase_full,8,0.12,10000,1004,2787,9507,3053,6454,834,993,1226,4918,1536,5394,45.272106885910034
phase_full,8,0.16,10000,1000,2767,9466,3069,6397,904,1001,1164,4808,1589,5353,44.287691593170166
phase_full,8,0.16,10000,1001,2779,10057,3227,6830,954,1027,1246,5150,1680,5689,54.33576726913452
phase_full,8,0.16,10000,1002,2755,9520,3113,6407,934,1037,1142,4937,1470,5301,58.017810106277466
phase_full,8,0.16,10000,1003,2775,9701,3040,6661,912,998,1130,5114,1547,5554,60.872973918914795
phase_full,8,0.16,10000,1004,2725,9632,3160,6472,962,1006,1192,4935,1537,5419,61.63907599449158
phase_full,8,0.2,10000,1000,2707,9352,3106,6246,995,1002,1109,4731,1515,5233,66.74292254447937
phase_full,8,0.2,10000,1001,2727,9866,3270,6596,1051,1068,1151,5069,1527,5639,71.73423027992249
phase_full,8,0.2,10000,1002,2715,9888,3218,6670,1032,1056,1130,5059,1611,5583,73.26186323165894
phase_full,8,0.2,10000,1003,2718,9700,3222,6478,1031,1019,1172,4949,1529,5507,69.24777960777283
phase_full,8,0.2,10000,1004,2669,9689,3175,6514,1028,1034,1113,4970,1544,5487,68.96426510810852
phase_full,8,0.24,10000,1000,2654,9533,3183,6350,1063,1029,1091,4860,1490,5328,69.46362161636353
phase_full,8,0.24,10000,1001,2663,9765,3329,6436,1124,1091,1114,4960,1476,5527,77.93911671638489
phase_full,8,0.24,10000,1002,2646,10219,3402,6817,1115,1082,1205,5212,1605,5763,78.26018452644348
phase_full,8,0.24,10000,1003,2647,9671,3239,6432,1100,1042,1097,4964,1468,5506,83.7260160446167
phase_full,8,0.24,10000,1004,2634,9957,3296,6661,1083,1058,1155,5052,1609,5590,83.6790418624878
phase_full,8,0.28,10000,1000,2588,9732,3266,6466,1160,1038,1068,4916,1550,5556,86.96982097625732
phase_full,8,0.28,10000,1001,2612,9808,3331,6477,1172,1054,1105,5020,1457,5659,85.02192234992981
phase_full,8,0.28,10000,1002,2608,9878,3276,6602,1151,1055,1070,5065,1537,5654,92.27703809738159
phase_full,8,0.28,10000,1003,2591,9842,3289,6553,1175,1055,1059,5108,1445,5632,92.96380686759949
phase_full,8,0.28,10000,1004,2592,9312,3159,6153,1086,1027,1046,4727,1426,5236,92.61740016937256
phase_full,8,0.32,10000,1000,2525,9140,3138,6002,1170,1022,946,4595,1407,5105,100.35201287269592
phase_full,8,0.32,10000,1001,2536,9553,3324,6229,1184,1050,1090,4842,1387,5423,103.59829044342041
phase_full,8,0.32,10000,1002,2557,9452,3222,6230,1168,1030,1024,4894,1336,5363,105.0577986240387
phase_full,8,0.32,10000,1003,2549,9721,3358,6363,1251,1046,1061,4932,1431,5584,112.01004838943481
phase_full,8,0.32,10000,1004,2526,9459,3159,6300,1106,1010,1043,4820,1480,5419,104.31583285331726
phase_full,8,0.36,10000,1000,2480,9250,3140,6110,1163,995,982,4735,1375,5298,116.44058609008789
phase_full,8,0.36,10000,1001,2474,9008,3107,5901,1168,1020,919,4582,1319,5160,115.71239423751831
phase_full,8,0.36,10000,1002,2477,9295,3195,6100,1189,1027,979,4633,1467,5237,126.0975067615509
phase_full,8,0.36,10000,1003,2474,9422,3206,6216,1217,1019,970,4832,1384,5361,129.10126090049744
phase_full,8,0.36,10000,1004,2486,9176,3085,6091,1128,976,981,4628,1463,5153,122.5953106880188
phase_full,8,0.4,10000,1000,2441,8875,3088,5787,1171,1006,911,4519,1268,5039,128.31809616088867
phase_full,8,0.4,10000,1001,2437,8733,3047,5686,1142,1007,898,4368,1318,5017,123.9850606918335
phase_full,8,0.4,10000,1002,2423,8741,3088,5653,1135,999,954,4378,1275,4986,123.91476225852966
