optimize_name,qubit,input_gates,p_t,seeds,H_edge,H + 2 qubit gates,H,2 qubit gates,gates_aft
clifford_simp_not_post_basic,4,100,0.0,1,22,23,12,11,28
clifford_simp_not_post_basic,4,100,0.0,2,18,19,10,9,24
clifford_simp_not_post_basic,4,100,0.0,3,20,22,11,11,29
clifford_simp_not_post_basic,4,100,0.0,4,20,20,9,11,23
clifford_simp_not_post_basic,4,100,0.0,5,22,25,12,13,32
clifford_simp_not_post_basic,4,100,0.04,1,47,36,16,20,46
clifford_simp_not_post_basic,4,100,0.04,2,38,34,14,20,43
clifford_simp_not_post_basic,4,100,0.04,3,19,22,10,12,29
clifford_simp_not_post_basic,4,100,0.04,4,22,22,10,12,29
clifford_simp_not_post_basic,4,100,0.04,5,22,21,9,12,28
clifford_simp_not_post_basic,4,100,0.08,1,33,34,15,19,45
clifford_simp_not_post_basic,4,100,0.08,2,30,27,12,15,38
clifford_simp_not_post_basic,4,100,0.08,3,20,24,10,14,32
clifford_simp_not_post_basic,4,100,0.08,4,34,26,12,14,30
clifford_simp_not_post_basic,4,100,0.08,5,43,43,22,21,55
clifford_simp_not_post_basic,4,100,0.12,1,56,50,19,31,65
clifford_simp_not_post_basic,4,100,0.12,2,40,37,16,21,50
clifford_simp_not_post_basic,4,100,0.12,3,41,41,20,21,55
clifford_simp_not_post_basic,4,100,0.12,4,33,36,16,20,45
clifford_simp_not_post_basic,4,100,0.12,5,50,41,16,25,53
clifford_simp_not_post_basic,4,100,0.16,1,48,47,20,27,62
clifford_simp_not_post_basic,4,100,0.16,2,39,43,21,22,58
clifford_simp_not_post_basic,4,100,0.16,3,39,38,16,22,50
clifford_simp_not_post_basic,4,100,0.16,4,41,44,19,25,54
clifford_simp_not_post_basic,4,100,0.16,5,52,51,22,29,66
clifford_simp_not_post_basic,4,100,0.2,1,55,55,23,32,68
clifford_simp_not_post_basic,4,100,0.2,2,34,31,18,13,43
clifford_simp_not_post_basic,4,100,0.2,3,54,45,22,23,60
clifford_simp_not_post_basic,4,100,0.2,4,41,44,19,25,58
clifford_simp_not_post_basic,4,100,0.2,5,36,39,18,21,53
clifford_simp_not_post_basic,4,100,0.24,1,66,63,27,36,79
clifford_simp_not_post_basic,4,100,0.24,2,39,42,25,17,58
clifford_simp_not_post_basic,4,100,0.24,3,42,41,20,21,55
clifford_simp_not_post_basic,4,100,0.24,4,47,47,20,27,59
clifford_simp_not_post_basic,4,100,0.24,5,65,48,23,25,60
clifford_simp_not_post_basic,4,100,0.28,1,65,51,23,28,64
clifford_simp_not_post_basic,4,100,0.28,2,31,28,15,13,39
clifford_simp_not_post_basic,4,100,0.28,3,54,47,22,25,64
clifford_simp_not_post_basic,4,100,0.28,4,46,45,22,23,59
clifford_simp_not_post_basic,4,100,0.28,5,66,56,23,33,71
clifford_simp_not_post_basic,4,100,0.32,1,47,43,19,24,57
clifford_simp_not_post_basic,4,100,0.32,2,27,25,14,11,35
clifford_simp_not_post_basic,4,100,0.32,3,61,54,24,30,73
clifford_simp_not_post_basic,4,100,0.32,4,43,46,20,26,60
clifford_simp_not_post_basic,4,100,0.32,5,62,58,24,34,73
clifford_simp_not_post_basic,4,100,0.36,1,44,44,23,21,58
clifford_simp_not_post_basic,4,100,0.36,2,25,28,16,12,38
clifford_simp_not_post_basic,4,100,0.36,3,58,48,23,25,65
clifford_simp_not_post_basic,4,100,0.36,4,34,35,19,16,48
clifford_simp_not_post_basic,4,100,0.36,5,58,53,26,27,68
clifford_simp_not_post_basic,4,100,0.4,1,46,46,26,20,58
clifford_simp_not_post_basic,4,100,0.4,2,25,26,16,10,35
clifford_simp_not_post_basic,4,100,0.4,3,63,60,29,31,82
clifford_simp_not_post_basic,4,100,0.4,4,51,56,26,30,70
clifford_simp_not_post_basic,4,100,0.4,5,61,46,25,21,62
clifford_simp_not_post_basic,4,1000,0.0,1,20,20,10,10,26
clifford_simp_not_post_basic,4,1000,0.0,2,23,22,10,12,30
clifford_simp_not_post_basic,4,1000,0.0,3,20,23,12,11,29
clifford_simp_not_post_basic,4,1000,0.0,4,15,17,10,7,21
clifford_simp_not_post_basic,4,1000,0.0,5,21,23,11,12,29
clifford_simp_not_post_basic,4,1000,0.04,1,180,113,41,72,148
clifford_simp_not_post_basic,4,1000,0.04,2,177,127,47,80,168
clifford_simp_not_post_basic,4,1000,0.04,3,127,101,40,61,135
clifford_simp_not_post_basic,4,1000,0.04,4,159,118,42,76,155
clifford_simp_not_post_basic,4,1000,0.04,5,155,120,45,75,160
clifford_simp_not_post_basic,4,1000,0.08,1,267,191,67,124,250
clifford_simp_not_post_basic,4,1000,0.08,2,319,204,78,126,270
clifford_simp_not_post_basic,4,1000,0.08,3,222,181,72,109,243
clifford_simp_not_post_basic,4,1000,0.08,4,261,200,78,122,266
clifford_simp_not_post_basic,4,1000,0.08,5,291,210,85,125,287
clifford_simp_not_post_basic,4,1000,0.12,1,353,228,89,139,312
clifford_simp_not_post_basic,4,1000,0.12,2,317,278,114,164,373
clifford_simp_not_post_basic,4,1000,0.12,3,270,207,82,125,280
clifford_simp_not_post_basic,4,1000,0.12,4,337,270,106,164,357
clifford_simp_not_post_basic,4,1000,0.12,5,376,280,103,177,376
clifford_simp_not_post_basic,4,1000,0.16,1,380,313,114,199,414
clifford_simp_not_post_basic,4,1000,0.16,2,381,334,130,204,437
clifford_simp_not_post_basic,4,1000,0.16,3,277,238,97,141,321
clifford_simp_not_post_basic,4,1000,0.16,4,381,332,130,202,438
clifford_simp_not_post_basic,4,1000,0.16,5,400,318,124,194,427
clifford_simp_not_post_basic,4,1000,0.2,1,443,349,136,213,464
clifford_simp_not_post_basic,4,1000,0.2,2,417,339,133,206,452
clifford_simp_not_post_basic,4,1000,0.2,3,360,278,104,174,368
clifford_simp_not_post_basic,4,1000,0.2,4,412,368,150,218,492
clifford_simp_not_post_basic,4,1000,0.2,5,371,292,116,176,394
clifford_simp_not_post_basic,4,1000,0.24,1,418,379,156,223,505
clifford_simp_not_post_basic,4,1000,0.24,2,398,340,147,193,457
clifford_simp_not_post_basic,4,1000,0.24,3,387,284,116,168,379
clifford_simp_not_post_basic,4,1000,0.24,4,411,364,152,212,492
clifford_simp_not_post_basic,4,1000,0.24,5,416,354,147,207,477
clifford_simp_not_post_basic,4,1000,0.28,1,438,392,156,236,517
clifford_simp_not_post_basic,4,1000,0.28,2,378,342,142,200,456
clifford_simp_not_post_basic,4,1000,0.28,3,374,328,140,188,443
clifford_simp_not_post_basic,4,1000,0.28,4,401,354,151,203,479
clifford_simp_not_post_basic,4,1000,0.28,5,402,339,143,196,462
clifford_simp_not_post_basic,4,1000,0.32,1,416,386,162,224,522
clifford_simp_not_post_basic,4,1000,0.32,2,399,336,133,203,449
clifford_simp_not_post_basic,4,1000,0.32,3,384,351,153,198,475
clifford_simp_not_post_basic,4,1000,0.32,4,452,381,159,222,505
clifford_simp_not_post_basic,4,1000,0.32,5,426,345,131,214,458
clifford_simp_not_post_basic,4,1000,0.36,1,462,397,171,226,533
clifford_simp_not_post_basic,4,1000,0.36,2,357,328,147,181,447
clifford_simp_not_post_basic,4,1000,0.36,3,468,354,149,205,480
clifford_simp_not_post_basic,4,1000,0.36,4,414,362,166,196,493
clifford_simp_not_post_basic,4,1000,0.36,5,422,364,147,217,488
clifford_simp_not_post_basic,4,1000,0.4,1,386,363,163,200,493
clifford_simp_not_post_basic,4,1000,0.4,2,350,298,144,154,409
clifford_simp_not_post_basic,4,1000,0.4,3,423,358,152,206,481
clifford_simp_not_post_basic,4,1000,0.4,4,434,407,178,229,545
clifford_simp_not_post_basic,4,1000,0.4,5,407,353,152,201,471
clifford_simp_not_post_basic,4,3000,0.0,1,23,21,11,10,25
clifford_simp_not_post_basic,4,3000,0.0,2,17,17,8,9,22
clifford_simp_not_post_basic,4,3000,0.0,3,13,14,7,7,21
clifford_simp_not_post_basic,4,3000,0.0,4,24,25,12,13,33
clifford_simp_not_post_basic,4,3000,0.0,5,19,21,10,11,29
clifford_simp_not_post_basic,4,3000,0.04,1,463,249,89,160,334
clifford_simp_not_post_basic,4,3000,0.04,2,456,310,115,195,415
clifford_simp_not_post_basic,4,3000,0.04,3,482,303,104,199,398
clifford_simp_not_post_basic,4,3000,0.04,4,530,310,108,202,408
clifford_simp_not_post_basic,4,3000,0.04,5,490,339,120,219,449
clifford_simp_not_post_basic,4,3000,0.08,1,726,513,183,330,683
clifford_simp_not_post_basic,4,3000,0.08,2,758,558,207,351,745
clifford_simp_not_post_basic,4,3000,0.08,3,777,531,195,336,704
clifford_simp_not_post_basic,4,3000,0.08,4,833,568,205,363,750
clifford_simp_not_post_basic,4,3000,0.08,5,896,591,222,369,797
clifford_simp_not_post_basic,4,3000,0.12,1,869,630,230,400,843
clifford_simp_not_post_basic,4,3000,0.12,2,964,771,296,475,1023
clifford_simp_not_post_basic,4,3000,0.12,3,854,629,238,391,844
clifford_simp_not_post_basic,4,3000,0.12,4,1163,748,278,470,990
clifford_simp_not_post_basic,4,3000,0.12,5,1094,835,301,534,1107
clifford_simp_not_post_basic,4,3000,0.16,1,1013,827,318,509,1106
clifford_simp_not_post_basic,4,3000,0.16,2,1040,859,344,515,1152
clifford_simp_not_post_basic,4,3000,0.16,3,957,741,278,463,990
clifford_simp_not_post_basic,4,3000,0.16,4,1072,843,326,517,1123
clifford_simp_not_post_basic,4,3000,0.16,5,1123,903,356,547,1219
clifford_simp_not_post_basic,4,3000,0.2,1,1208,939,370,569,1260
clifford_simp_not_post_basic,4,3000,0.2,2,1135,927,376,551,1252
clifford_simp_not_post_basic,4,3000,0.2,3,1030,851,328,523,1135
clifford_simp_not_post_basic,4,3000,0.2,4,1141,921,369,552,1245
clifford_simp_not_post_basic,4,3000,0.2,5,1222,961,376,585,1284
clifford_simp_not_post_basic,4,3000,0.24,1,1200,994,397,597,1331
clifford_simp_not_post_basic,4,3000,0.24,2,1154,1011,412,599,1356
clifford_simp_not_post_basic,4,3000,0.24,3,1048,855,331,524,1145
clifford_simp_not_post_basic,4,3000,0.24,4,1217,953,374,579,1283
clifford_simp_not_post_basic,4,3000,0.24,5,1274,1041,425,616,1403
clifford_simp_not_post_basic,4,3000,0.28,1,1168,1014,411,603,1352
clifford_simp_not_post_basic,4,3000,0.28,2,1153,1011,415,596,1357
clifford_simp_not_post_basic,4,3000,0.28,3,1084,942,392,550,1277
clifford_simp_not_post_basic,4,3000,0.28,4,1140,977,403,574,1323
clifford_simp_not_post_basic,4,3000,0.28,5,1215,1027,422,605,1394
clifford_simp_not_post_basic,4,3000,0.32,1,1204,1024,431,593,1383
clifford_simp_not_post_basic,4,3000,0.32,2,1164,1015,437,578,1373
clifford_simp_not_post_basic,4,3000,0.32,3,1147,1015,427,588,1367
clifford_simp_not_post_basic,4,3000,0.32,4,1186,1001,405,596,1341
clifford_simp_not_post_basic,4,3000,0.32,5,1289,1062,427,635,1425
clifford_simp_not_post_basic,4,3000,0.36,1,1134,1013,436,577,1369
clifford_simp_not_post_basic,4,3000,0.36,2,1187,1039,450,589,1403
clifford_simp_not_post_basic,4,3000,0.36,3,1257,964,395,569,1296
clifford_simp_not_post_basic,4,3000,0.36,4,1206,985,410,575,1330
clifford_simp_not_post_basic,4,3000,0.36,5,1185,1027,426,601,1390
clifford_simp_not_post_basic,4,3000,0.4,1,1092,973,422,551,1317
clifford_simp_not_post_basic,4,3000,0.4,2,1147,979,437,542,1337
clifford_simp_not_post_basic,4,3000,0.4,3,1085,944,400,544,1279
clifford_simp_not_post_basic,4,3000,0.4,4,1092,994,431,563,1353
clifford_simp_not_post_basic,4,3000,0.4,5,1138,1005,439,566,1367
clifford_simp_not_post_basic,4,5000,0.0,1,26,25,11,14,30
clifford_simp_not_post_basic,4,5000,0.0,2,22,26,11,15,32
clifford_simp_not_post_basic,4,5000,0.0,3,20,21,10,11,27
clifford_simp_not_post_basic,4,5000,0.0,4,21,22,11,11,30
clifford_simp_not_post_basic,4,5000,0.0,5,18,19,10,9,25
clifford_simp_not_post_basic,4,5000,0.04,1,803,477,165,312,634
clifford_simp_not_post_basic,4,5000,0.04,2,811,528,183,345,699
clifford_simp_not_post_basic,4,5000,0.04,3,706,492,171,321,655
clifford_simp_not_post_basic,4,5000,0.04,4,907,505,176,329,670
clifford_simp_not_post_basic,4,5000,0.04,5,940,557,193,364,734
clifford_simp_not_post_basic,4,5000,0.08,1,1210,844,297,547,1124
clifford_simp_not_post_basic,4,5000,0.08,2,1280,942,350,592,1252
clifford_simp_not_post_basic,4,5000,0.08,3,1366,871,312,559,1164
clifford_simp_not_post_basic,4,5000,0.08,4,1305,953,342,611,1256
clifford_simp_not_post_basic,4,5000,0.08,5,1484,983,359,624,1307
clifford_simp_not_post_basic,4,5000,0.12,1,1386,1024,375,649,1376
clifford_simp_not_post_basic,4,5000,0.12,2,1670,1270,470,800,1681
clifford_simp_not_post_basic,4,5000,0.12,3,1435,1073,403,670,1436
clifford_simp_not_post_basic,4,5000,0.12,4,1759,1226,460,766,1632
clifford_simp_not_post_basic,4,5000,0.12,5,1778,1331,482,849,1768
clifford_simp_not_post_basic,4,5000,0.16,1,1770,1299,488,811,1738
clifford_simp_not_post_basic,4,5000,0.16,2,1774,1409,540,869,1882
clifford_simp_not_post_basic,4,5000,0.16,3,1689,1297,483,814,1731
clifford_simp_not_post_basic,4,5000,0.16,4,1706,1408,547,861,1883
clifford_simp_not_post_basic,4,5000,0.16,5,1857,1475,558,917,1977
clifford_simp_not_post_basic,4,5000,0.2,1,1934,1489,580,909,1997
clifford_simp_not_post_basic,4,5000,0.2,2,1945,1530,612,918,2066
clifford_simp_not_post_basic,4,5000,0.2,3,1813,1481,571,910,1982
clifford_simp_not_post_basic,4,5000,0.2,4,1842,1494,590,904,2012
clifford_simp_not_post_basic,4,5000,0.2,5,2020,1530,591,939,2047
clifford_simp_not_post_basic,4,5000,0.24,1,2069,1642,623,1019,2181
clifford_simp_not_post_basic,4,5000,0.24,2,1944,1664,680,984,2236
clifford_simp_not_post_basic,4,5000,0.24,3,1804,1495,594,901,2015
clifford_simp_not_post_basic,4,5000,0.24,4,2003,1583,630,953,2129
clifford_simp_not_post_basic,4,5000,0.24,5,2037,1629,652,977,2184
clifford_simp_not_post_basic,4,5000,0.28,1,1945,1676,669,1007,2242
clifford_simp_not_post_basic,4,5000,0.28,2,1906,1634,679,955,2208
clifford_simp_not_post_basic,4,5000,0.28,3,1920,1623,664,959,2194
clifford_simp_not_post_basic,4,5000,0.28,4,1945,1663,681,982,2237
clifford_simp_not_post_basic,4,5000,0.28,5,1994,1631,661,970,2202
clifford_simp_not_post_basic,4,5000,0.32,1,1962,1693,704,989,2280
clifford_simp_not_post_basic,4,5000,0.32,2,1944,1675,709,966,2261
clifford_simp_not_post_basic,4,5000,0.32,3,1904,1666,684,982,2244
clifford_simp_not_post_basic,4,5000,0.32,4,1994,1715,714,1001,2297
clifford_simp_not_post_basic,4,5000,0.32,5,2063,1674,663,1011,2240
clifford_simp_not_post_basic,4,5000,0.36,1,1928,1644,716,928,2232
clifford_simp_not_post_basic,4,5000,0.36,2,1889,1682,730,952,2283
clifford_simp_not_post_basic,4,5000,0.36,3,2028,1586,643,943,2134
clifford_simp_not_post_basic,4,5000,0.36,4,1982,1666,712,954,2248
clifford_simp_not_post_basic,4,5000,0.36,5,1954,1672,683,989,2249
clifford_simp_not_post_basic,4,5000,0.4,1,1921,1651,712,939,2238
clifford_simp_not_post_basic,4,5000,0.4,2,1934,1659,715,944,2250
clifford_simp_not_post_basic,4,5000,0.4,3,1839,1588,661,927,2148
clifford_simp_not_post_basic,4,5000,0.4,4,1854,1605,683,922,2181
clifford_simp_not_post_basic,4,5000,0.4,5,1910,1640,702,938,2220
clifford_simp_not_post_basic,4,8000,0.0,1,20,22,10,12,29
clifford_simp_not_post_basic,4,8000,0.0,2,16,18,9,9,24
clifford_simp_not_post_basic,4,8000,0.0,3,13,13,7,6,21
clifford_simp_not_post_basic,4,8000,0.0,4,16,16,10,6,23
clifford_simp_not_post_basic,4,8000,0.0,5,12,12,7,5,16
clifford_simp_not_post_basic,4,8000,0.04,1,1194,760,267,493,1015
clifford_simp_not_post_basic,4,8000,0.04,2,1355,789,271,518,1045
clifford_simp_not_post_basic,4,8000,0.04,3,1100,773,278,495,1033
clifford_simp_not_post_basic,4,8000,0.04,4,1857,791,274,517,1051
clifford_simp_not_post_basic,4,8000,0.04,5,1385,853,300,553,1137
clifford_simp_not_post_basic,4,8000,0.08,1,1973,1333,477,856,1775
clifford_simp_not_post_basic,4,8000,0.08,2,2279,1454,529,925,1939
clifford_simp_not_post_basic,4,8000,0.08,3,2085,1395,513,882,1865
clifford_simp_not_post_basic,4,8000,0.08,4,2185,1488,531,957,1966
clifford_simp_not_post_basic,4,8000,0.08,5,2312,1511,544,967,2013
clifford_simp_not_post_basic,4,8000,0.12,1,2407,1753,633,1120,2344
clifford_simp_not_post_basic,4,8000,0.12,2,2517,1921,711,1210,2553
clifford_simp_not_post_basic,4,8000,0.12,3,2525,1776,656,1120,2379
clifford_simp_not_post_basic,4,8000,0.12,4,2649,1848,682,1166,2461
clifford_simp_not_post_basic,4,8000,0.12,5,2832,1938,718,1220,2593
clifford_simp_not_post_basic,4,8000,0.16,1,3033,2120,797,1323,2835
clifford_simp_not_post_basic,4,8000,0.16,2,2860,2173,835,1338,2908
clifford_simp_not_post_basic,4,8000,0.16,3,2826,2171,804,1367,2886
clifford_simp_not_post_basic,4,8000,0.16,4,2764,2143,824,1319,2870
clifford_simp_not_post_basic,4,8000,0.16,5,2888,2251,847,1404,3005
clifford_simp_not_post_basic,4,8000,0.2,1,3057,2414,943,1471,3230
clifford_simp_not_post_basic,4,8000,0.2,2,3018,2443,958,1485,3285
clifford_simp_not_post_basic,4,8000,0.2,3,2946,2416,939,1477,3235
clifford_simp_not_post_basic,4,8000,0.2,4,2940,2325,903,1422,3118
clifford_simp_not_post_basic,4,8000,0.2,5,3047,2405,923,1482,3211
clifford_simp_not_post_basic,4,8000,0.24,1,3200,2600,1016,1584,3472
clifford_simp_not_post_basic,4,8000,0.24,2,3038,2571,1035,1536,3459
clifford_simp_not_post_basic,4,8000,0.24,3,2985,2452,989,1463,3318
clifford_simp_not_post_basic,4,8000,0.24,4,3014,2428,962,1466,3270
clifford_simp_not_post_basic,4,8000,0.24,5,3281,2651,1043,1608,3544
clifford_simp_not_post_basic,4,8000,0.28,1,3202,2715,1092,1623,3639
clifford_simp_not_post_basic,4,8000,0.28,2,3138,2628,1088,1540,3551
clifford_simp_not_post_basic,4,8000,0.28,3,3035,2573,1063,1510,3478
clifford_simp_not_post_basic,4,8000,0.28,4,3098,2544,1025,1519,3411
clifford_simp_not_post_basic,4,8000,0.28,5,3285,2720,1081,1639,3647
clifford_simp_not_post_basic,4,8000,0.32,1,3092,2676,1112,1564,3622
clifford_simp_not_post_basic,4,8000,0.32,2,3295,2716,1148,1568,3671
clifford_simp_not_post_basic,4,8000,0.32,3,3067,2601,1086,1515,3518
clifford_simp_not_post_basic,4,8000,0.32,4,3103,2578,1067,1511,3466
clifford_simp_not_post_basic,4,8000,0.32,5,3241,2718,1084,1634,3640
clifford_simp_not_post_basic,4,8000,0.36,1,3026,2677,1157,1520,3636
clifford_simp_not_post_basic,4,8000,0.36,2,3089,2715,1199,1516,3695
clifford_simp_not_post_basic,4,8000,0.36,3,3055,2459,1032,1427,3339
clifford_simp_not_post_basic,4,8000,0.36,4,3111,2596,1106,1490,3509
clifford_simp_not_post_basic,4,8000,0.36,5,3158,2657,1085,1572,3566
clifford_simp_not_post_basic,4,8000,0.4,1,3074,2621,1117,1504,3546
clifford_simp_not_post_basic,4,8000,0.4,2,3115,2755,1200,1555,3740
clifford_simp_not_post_basic,4,8000,0.4,3,3013,2468,1057,1411,3353
clifford_simp_not_post_basic,4,8000,0.4,4,2985,2550,1065,1485,3450
clifford_simp_not_post_basic,4,8000,0.4,5,3019,2574,1107,1467,3492
clifford_simp_not_post_basic,4,10000,0.0,1,16,17,9,8,23
clifford_simp_not_post_basic,4,10000,0.0,2,19,23,11,12,30
clifford_simp_not_post_basic,4,10000,0.0,3,17,21,12,9,25
clifford_simp_not_post_basic,4,10000,0.0,4,19,20,11,9,28
clifford_simp_not_post_basic,4,10000,0.0,5,16,20,11,9,27
clifford_simp_not_post_basic,4,10000,0.04,1,1562,961,334,627,1284
clifford_simp_not_post_basic,4,10000,0.04,2,1723,984,342,642,1310
clifford_simp_not_post_basic,4,10000,0.04,3,1328,890,323,567,1201
clifford_simp_not_post_basic,4,10000,0.04,4,1981,1025,351,674,1360
clifford_simp_not_post_basic,4,10000,0.04,5,1645,1076,378,698,1425
clifford_simp_not_post_basic,4,10000,0.08,1,2487,1712,599,1113,2271
clifford_simp_not_post_basic,4,10000,0.08,2,2609,1779,651,1128,2371
clifford_simp_not_post_basic,4,10000,0.08,3,2553,1712,620,1092,2279
clifford_simp_not_post_basic,4,10000,0.08,4,2753,1790,649,1141,2378
clifford_simp_not_post_basic,4,10000,0.08,5,2682,1876,672,1204,2497
clifford_simp_not_post_basic,4,10000,0.12,1,3006,2232,824,1408,2990
clifford_simp_not_post_basic,4,10000,0.12,2,3458,2374,871,1503,3159
clifford_simp_not_post_basic,4,10000,0.12,3,2935,2199,825,1374,2934
clifford_simp_not_post_basic,4,10000,0.12,4,3311,2302,848,1454,3062
clifford_simp_not_post_basic,4,10000,0.12,5,3504,2424,890,1534,3233
clifford_simp_not_post_basic,4,10000,0.16,1,3757,2730,1024,1706,3643
clifford_simp_not_post_basic,4,10000,0.16,2,3801,2731,1042,1689,3647
clifford_simp_not_post_basic,4,10000,0.16,3,3498,2699,994,1705,3591
clifford_simp_not_post_basic,4,10000,0.16,4,3429,2693,1026,1667,3597
clifford_simp_not_post_basic,4,10000,0.16,5,3667,2824,1060,1764,3776
clifford_simp_not_post_basic,4,10000,0.2,1,3973,3092,1192,1900,4125
clifford_simp_not_post_basic,4,10000,0.2,2,3719,3009,1170,1839,4042
clifford_simp_not_post_basic,4,10000,0.2,3,3752,3056,1182,1874,4092
clifford_simp_not_post_basic,4,10000,0.2,4,3725,2935,1146,1789,3934
clifford_simp_not_post_basic,4,10000,0.2,5,3781,3024,1155,1869,4034
clifford_simp_not_post_basic,4,10000,0.24,1,4028,3281,1279,2002,4379
clifford_simp_not_post_basic,4,10000,0.24,2,3935,3196,1278,1918,4300
clifford_simp_not_post_basic,4,10000,0.24,3,3669,3068,1243,1825,4148
clifford_simp_not_post_basic,4,10000,0.24,4,3854,3116,1229,1887,4181
clifford_simp_not_post_basic,4,10000,0.24,5,3987,3292,1293,1999,4404
clifford_simp_not_post_basic,4,10000,0.28,1,3971,3358,1351,2007,4509
clifford_simp_not_post_basic,4,10000,0.28,2,4046,3329,1350,1979,4480
clifford_simp_not_post_basic,4,10000,0.28,3,3838,3206,1314,1892,4332
clifford_simp_not_post_basic,4,10000,0.28,4,3791,3194,1306,1888,4293
clifford_simp_not_post_basic,4,10000,0.28,5,4060,3338,1318,2020,4481
clifford_simp_not_post_basic,4,10000,0.32,1,3907,3379,1408,1971,4577
clifford_simp_not_post_basic,4,10000,0.32,2,4214,3375,1413,1962,4555
clifford_simp_not_post_basic,4,10000,0.32,3,3836,3294,1367,1927,4457
clifford_simp_not_post_basic,4,10000,0.32,4,3860,3237,1341,1896,4356
clifford_simp_not_post_basic,4,10000,0.32,5,4071,3347,1332,2015,4485
clifford_simp_not_post_basic,4,10000,0.36,1,3905,3389,1465,1924,4599
clifford_simp_not_post_basic,4,10000,0.36,2,3929,3423,1488,1935,4647
clifford_simp_not_post_basic,4,10000,0.36,3,3876,3114,1290,1824,4214
clifford_simp_not_post_basic,4,10000,0.36,4,3851,3223,1381,1842,4369
clifford_simp_not_post_basic,4,10000,0.36,5,3959,3350,1371,1979,4502
clifford_simp_not_post_basic,4,10000,0.4,1,3805,3322,1414,1908,4495
clifford_simp_not_post_basic,4,10000,0.4,2,3915,3359,1437,1922,4551
clifford_simp_not_post_basic,4,10000,0.4,3,3769,3154,1329,1825,4274
clifford_simp_not_post_basic,4,10000,0.4,4,3704,3169,1332,1837,4295
clifford_simp_not_post_basic,4,10000,0.4,5,3783,3242,1386,1856,4393
clifford_simp_not_post_basic,8,100,0.0,1,62,59,19,40,70
clifford_simp_not_post_basic,8,100,0.0,2,62,60,21,39,73
clifford_simp_not_post_basic,8,100,0.0,3,68,66,20,46,76
clifford_simp_not_post_basic,8,100,0.0,4,41,48,20,28,56
clifford_simp_not_post_basic,8,100,0.0,5,63,65,21,44,77
clifford_simp_not_post_basic,8,100,0.04,1,75,69,21,48,83
clifford_simp_not_post_basic,8,100,0.04,2,80,78,26,52,92
clifford_simp_not_post_basic,8,100,0.04,3,70,66,20,46,77
clifford_simp_not_post_basic,8,100,0.04,4,69,62,22,40,76
clifford_simp_not_post_basic,8,100,0.04,5,72,69,24,45,80
clifford_simp_not_post_basic,8,100,0.08,1,76,70,22,48,85
clifford_simp_not_post_basic,8,100,0.08,2,62,56,27,29,73
clifford_simp_not_post_basic,8,100,0.08,3,73,66,22,44,80
clifford_simp_not_post_basic,8,100,0.08,4,69,62,21,41,76
clifford_simp_not_post_basic,8,100,0.08,5,73,73,23,50,87
clifford_simp_not_post_basic,8,100,0.12,1,72,66,22,44,81
clifford_simp_not_post_basic,8,100,0.12,2,59,63,27,36,80
clifford_simp_not_post_basic,8,100,0.12,3,69,65,26,39,81
clifford_simp_not_post_basic,8,100,0.12,4,70,66,22,44,82
clifford_simp_not_post_basic,8,100,0.12,5,86,82,31,51,104
clifford_simp_not_post_basic,8,100,0.16,1,60,66,25,41,81
clifford_simp_not_post_basic,8,100,0.16,2,60,65,26,39,79
clifford_simp_not_post_basic,8,100,0.16,3,89,81,25,56,100
clifford_simp_not_post_basic,8,100,0.16,4,69,72,27,45,89
clifford_simp_not_post_basic,8,100,0.16,5,88,80,27,53,102
clifford_simp_not_post_basic,8,100,0.2,1,60,67,27,40,83
clifford_simp_not_post_basic,8,100,0.2,2,72,75,33,42,94
clifford_simp_not_post_basic,8,100,0.2,3,80,76,30,46,94
clifford_simp_not_post_basic,8,100,0.2,4,72,71,27,44,86
clifford_simp_not_post_basic,8,100,0.2,5,103,87,26,61,108
clifford_simp_not_post_basic,8,100,0.24,1,68,71,27,44,88
clifford_simp_not_post_basic,8,100,0.24,2,77,81,34,47,100
clifford_simp_not_post_basic,8,100,0.24,3,95,82,28,54,103
clifford_simp_not_post_basic,8,100,0.24,4,78,78,26,52,96
clifford_simp_not_post_basic,8,100,0.24,5,60,61,26,35,79
clifford_simp_not_post_basic,8,100,0.28,1,72,70,29,41,88
clifford_simp_not_post_basic,8,100,0.28,2,63,70,34,36,90
clifford_simp_not_post_basic,8,100,0.28,3,92,88,34,54,111
clifford_simp_not_post_basic,8,100,0.28,4,71,73,30,43,93
clifford_simp_not_post_basic,8,100,0.28,5,68,69,28,41,87
clifford_simp_not_post_basic,8,100,0.32,1,91,82,34,48,104
clifford_simp_not_post_basic,8,100,0.32,2,63,67,33,34,89
clifford_simp_not_post_basic,8,100,0.32,3,100,84,35,49,109
clifford_simp_not_post_basic,8,100,0.32,4,74,76,28,48,96
clifford_simp_not_post_basic,8,100,0.32,5,86,78,36,42,97
clifford_simp_not_post_basic,8,100,0.36,1,75,76,27,49,94
clifford_simp_not_post_basic,8,100,0.36,2,67,73,34,39,95
clifford_simp_not_post_basic,8,100,0.36,3,92,79,38,41,105
clifford_simp_not_post_basic,8,100,0.36,4,63,69,33,36,92
clifford_simp_not_post_basic,8,100,0.36,5,81,85,39,46,107
clifford_simp_not_post_basic,8,100,0.4,1,71,67,28,39,89
clifford_simp_not_post_basic,8,100,0.4,2,62,59,35,24,77
clifford_simp_not_post_basic,8,100,0.4,3,93,87,37,50,108
clifford_simp_not_post_basic,8,100,0.4,4,53,59,27,32,78
clifford_simp_not_post_basic,8,100,0.4,5,85,95,46,49,119
clifford_simp_not_post_basic,8,1000,0.0,1,71,69,25,44,82
clifford_simp_not_post_basic,8,1000,0.0,2,70,63,18,45,73
clifford_simp_not_post_basic,8,1000,0.0,3,77,72,25,47,84
clifford_simp_not_post_basic,8,1000,0.0,4,63,70,26,44,83
clifford_simp_not_post_basic,8,1000,0.0,5,68,64,22,42,75
clifford_simp_not_post_basic,8,1000,0.04,1,351,209,54,155,249
clifford_simp_not_post_basic,8,1000,0.04,2,466,231,58,173,278
clifford_simp_not_post_basic,8,1000,0.04,3,580,245,57,188,286
clifford_simp_not_post_basic,8,1000,0.04,4,370,219,55,164,260
clifford_simp_not_post_basic,8,1000,0.04,5,482,232,57,175,275
clifford_simp_not_post_basic,8,1000,0.08,1,885,348,76,272,415
clifford_simp_not_post_basic,8,1000,0.08,2,930,398,90,308,474
clifford_simp_not_post_basic,8,1000,0.08,3,690,350,80,270,416
clifford_simp_not_post_basic,8,1000,0.08,4,594,368,85,283,442
clifford_simp_not_post_basic,8,1000,0.08,5,841,406,88,318,480
clifford_simp_not_post_basic,8,1000,0.12,1,887,478,113,365,567
clifford_simp_not_post_basic,8,1000,0.12,2,853,461,106,355,554
clifford_simp_not_post_basic,8,1000,0.12,3,627,357,94,263,434
clifford_simp_not_post_basic,8,1000,0.12,4,825,511,125,386,617
clifford_simp_not_post_basic,8,1000,0.12,5,793,494,112,382,594
clifford_simp_not_post_basic,8,1000,0.16,1,684,516,132,384,621
clifford_simp_not_post_basic,8,1000,0.16,2,726,509,128,381,617
clifford_simp_not_post_basic,8,1000,0.16,3,669,411,100,311,500
clifford_simp_not_post_basic,8,1000,0.16,4,820,595,159,436,721
clifford_simp_not_post_basic,8,1000,0.16,5,740,487,120,367,596
clifford_simp_not_post_basic,8,1000,0.2,1,687,512,148,364,631
clifford_simp_not_post_basic,8,1000,0.2,2,953,523,139,384,644
clifford_simp_not_post_basic,8,1000,0.2,3,685,458,120,338,556
clifford_simp_not_post_basic,8,1000,0.2,4,779,565,167,398,694
clifford_simp_not_post_basic,8,1000,0.2,5,724,506,134,372,619
clifford_simp_not_post_basic,8,1000,0.24,1,793,550,159,391,675
clifford_simp_not_post_basic,8,1000,0.24,2,662,524,146,378,646
clifford_simp_not_post_basic,8,1000,0.24,3,822,475,121,354,580
clifford_simp_not_post_basic,8,1000,0.24,4,864,630,179,451,771
clifford_simp_not_post_basic,8,1000,0.24,5,722,537,165,372,667
clifford_simp_not_post_basic,8,1000,0.28,1,874,578,157,421,701
clifford_simp_not_post_basic,8,1000,0.28,2,681,540,160,380,672
clifford_simp_not_post_basic,8,1000,0.28,3,677,448,114,334,544
clifford_simp_not_post_basic,8,1000,0.28,4,685,564,175,389,699
clifford_simp_not_post_basic,8,1000,0.28,5,805,554,164,390,686
clifford_simp_not_post_basic,8,1000,0.32,1,689,584,181,403,722
clifford_simp_not_post_basic,8,1000,0.32,2,615,517,159,358,649
clifford_simp_not_post_basic,8,1000,0.32,3,691,499,131,368,608
clifford_simp_not_post_basic,8,1000,0.32,4,747,560,158,402,685
clifford_simp_not_post_basic,8,1000,0.32,5,710,555,177,378,696
clifford_simp_not_post_basic,8,1000,0.36,1,764,542,149,393,660
clifford_simp_not_post_basic,8,1000,0.36,2,548,474,149,325,598
clifford_simp_not_post_basic,8,1000,0.36,3,648,482,142,340,608
clifford_simp_not_post_basic,8,1000,0.36,4,635,534,174,360,670
clifford_simp_not_post_basic,8,1000,0.36,5,668,586,199,387,734
clifford_simp_not_post_basic,8,1000,0.4,1,739,552,162,390,684
clifford_simp_not_post_basic,8,1000,0.4,2,549,468,170,298,599
clifford_simp_not_post_basic,8,1000,0.4,3,625,468,151,317,590
clifford_simp_not_post_basic,8,1000,0.4,4,711,528,170,358,658
clifford_simp_not_post_basic,8,1000,0.4,5,681,598,196,402,746
clifford_simp_not_post_basic,8,3000,0.0,1,73,71,23,48,84
clifford_simp_not_post_basic,8,3000,0.0,2,70,66,22,44,81
clifford_simp_not_post_basic,8,3000,0.0,3,68,69,23,46,80
clifford_simp_not_post_basic,8,3000,0.0,4,69,74,27,47,87
clifford_simp_not_post_basic,8,3000,0.0,5,71,70,23,47,81
clifford_simp_not_post_basic,8,3000,0.04,1,1194,514,109,405,609
clifford_simp_not_post_basic,8,3000,0.04,2,2735,638,129,509,757
clifford_simp_not_post_basic,8,3000,0.04,3,2055,635,126,509,750
clifford_simp_not_post_basic,8,3000,0.04,4,2017,611,122,489,720
clifford_simp_not_post_basic,8,3000,0.04,5,2001,568,116,452,674
clifford_simp_not_post_basic,8,3000,0.08,1,3573,1000,204,796,1190
clifford_simp_not_post_basic,8,3000,0.08,2,2652,1133,241,892,1354
clifford_simp_not_post_basic,8,3000,0.08,3,2124,1046,218,828,1245
clifford_simp_not_post_basic,8,3000,0.08,4,3775,1000,207,793,1191
clifford_simp_not_post_basic,8,3000,0.08,5,2544,1089,229,860,1295
clifford_simp_not_post_basic,8,3000,0.12,1,2289,1228,273,955,1471
clifford_simp_not_post_basic,8,3000,0.12,2,2803,1370,302,1068,1644
clifford_simp_not_post_basic,8,3000,0.12,3,2831,1192,270,922,1438
clifford_simp_not_post_basic,8,3000,0.12,4,2986,1337,298,1039,1600
clifford_simp_not_post_basic,8,3000,0.12,5,2336,1314,300,1014,1585
clifford_simp_not_post_basic,8,3000,0.16,1,2127,1382,332,1050,1674
clifford_simp_not_post_basic,8,3000,0.16,2,2635,1495,363,1132,1816
clifford_simp_not_post_basic,8,3000,0.16,3,2136,1345,307,1038,1621
clifford_simp_not_post_basic,8,3000,0.16,4,2637,1568,372,1196,1892
clifford_simp_not_post_basic,8,3000,0.16,5,2418,1451,348,1103,1757
clifford_simp_not_post_basic,8,3000,0.2,1,2153,1478,378,1100,1799
clifford_simp_not_post_basic,8,3000,0.2,2,2622,1561,397,1164,1907
clifford_simp_not_post_basic,8,3000,0.2,3,2354,1505,357,1148,1818
clifford_simp_not_post_basic,8,3000,0.2,4,2426,1515,384,1131,1837
clifford_simp_not_post_basic,8,3000,0.2,5,2438,1509,393,1116,1847
clifford_simp_not_post_basic,8,3000,0.24,1,2219,1627,415,1212,1976
clifford_simp_not_post_basic,8,3000,0.24,2,2278,1556,400,1156,1900
clifford_simp_not_post_basic,8,3000,0.24,3,2519,1517,376,1141,1844
clifford_simp_not_post_basic,8,3000,0.24,4,2416,1543,409,1134,1890
clifford_simp_not_post_basic,8,3000,0.24,5,2180,1512,419,1093,1860
clifford_simp_not_post_basic,8,3000,0.28,1,2028,1565,434,1131,1927
clifford_simp_not_post_basic,8,3000,0.28,2,2426,1636,460,1176,2015
clifford_simp_not_post_basic,8,3000,0.28,3,2238,1474,382,1092,1805
clifford_simp_not_post_basic,8,3000,0.28,4,2170,1557,427,1130,1923
clifford_simp_not_post_basic,8,3000,0.28,5,2143,1489,415,1074,1841
clifford_simp_not_post_basic,8,3000,0.32,1,2085,1601,477,1124,1992
clifford_simp_not_post_basic,8,3000,0.32,2,1909,1492,443,1049,1853
clifford_simp_not_post_basic,8,3000,0.32,3,2397,1564,411,1153,1912
clifford_simp_not_post_basic,8,3000,0.32,4,2233,1564,424,1140,1924
clifford_simp_not_post_basic,8,3000,0.32,5,2207,1531,449,1082,1907
clifford_simp_not_post_basic,8,3000,0.36,1,1820,1476,449,1027,1847
clifford_simp_not_post_basic,8,3000,0.36,2,1898,1496,429,1067,1844
clifford_simp_not_post_basic,8,3000,0.36,3,1954,1456,436,1020,1821
clifford_simp_not_post_basic,8,3000,0.36,4,1906,1471,446,1025,1845
clifford_simp_not_post_basic,8,3000,0.36,5,2016,1583,478,1105,1971
clifford_simp_not_post_basic,8,3000,0.4,1,1988,1492,462,1030,1863
clifford_simp_not_post_basic,8,3000,0.4,2,1793,1463,466,997,1830
clifford_simp_not_post_basic,8,3000,0.4,3,2044,1429,417,1012,1774
clifford_simp_not_post_basic,8,3000,0.4,4,2054,1575,466,1109,1952
clifford_simp_not_post_basic,8,3000,0.4,5,1940,1505,480,1025,1888
clifford_simp_not_post_basic,8,5000,0.0,1,65,63,22,41,75
clifford_simp_not_post_basic,8,5000,0.0,2,73,68,22,46,81
clifford_simp_not_post_basic,8,5000,0.0,3,64,61,23,38,71
clifford_simp_not_post_basic,8,5000,0.0,4,71,69,20,49,81
clifford_simp_not_post_basic,8,5000,0.0,5,77,73,24,49,83
clifford_simp_not_post_basic,8,5000,0.04,1,2328,841,168,673,997
clifford_simp_not_post_basic,8,5000,0.04,2,5665,1018,194,824,1201
clifford_simp_not_post_basic,8,5000,0.04,3,4163,976,193,783,1156
clifford_simp_not_post_basic,8,5000,0.04,4,3769,959,195,764,1137
clifford_simp_not_post_basic,8,5000,0.04,5,3660,950,186,764,1121
clifford_simp_not_post_basic,8,5000,0.08,1,4982,1570,321,1249,1869
clifford_simp_not_post_basic,8,5000,0.08,2,4629,1722,359,1363,2059
clifford_simp_not_post_basic,8,5000,0.08,3,3385,1630,340,1290,1948
clifford_simp_not_post_basic,8,5000,0.08,4,4588,1612,328,1284,1919
clifford_simp_not_post_basic,8,5000,0.08,5,5857,1651,344,1307,1971
clifford_simp_not_post_basic,8,5000,0.12,1,4142,1949,432,1517,2334
clifford_simp_not_post_basic,8,5000,0.12,2,4442,2186,475,1711,2621
clifford_simp_not_post_basic,8,5000,0.12,3,4261,2029,443,1586,2433
clifford_simp_not_post_basic,8,5000,0.12,4,5106,2217,479,1738,2648
clifford_simp_not_post_basic,8,5000,0.12,5,3988,2135,473,1662,2571
clifford_simp_not_post_basic,8,5000,0.16,1,3899,2310,531,1779,2781
clifford_simp_not_post_basic,8,5000,0.16,2,4094,2432,583,1849,2950
clifford_simp_not_post_basic,8,5000,0.16,3,4005,2388,541,1847,2880
clifford_simp_not_post_basic,8,5000,0.16,4,4668,2492,585,1907,3015
clifford_simp_not_post_basic,8,5000,0.16,5,3922,2442,569,1873,2956
clifford_simp_not_post_basic,8,5000,0.2,1,4209,2536,609,1927,3062
clifford_simp_not_post_basic,8,5000,0.2,2,3806,2458,624,1834,3004
clifford_simp_not_post_basic,8,5000,0.2,3,4283,2540,614,1926,3081
clifford_simp_not_post_basic,8,5000,0.2,4,4071,2505,599,1906,3029
clifford_simp_not_post_basic,8,5000,0.2,5,3986,2539,624,1915,3088
clifford_simp_not_post_basic,8,5000,0.24,1,3831,2560,651,1909,3127
clifford_simp_not_post_basic,8,5000,0.24,2,3773,2498,650,1848,3056
clifford_simp_not_post_basic,8,5000,0.24,3,3958,2577,647,1930,3140
clifford_simp_not_post_basic,8,5000,0.24,4,3817,2559,663,1896,3128
clifford_simp_not_post_basic,8,5000,0.24,5,3626,2511,687,1824,3088
clifford_simp_not_post_basic,8,5000,0.28,1,3529,2599,687,1912,3182
clifford_simp_not_post_basic,8,5000,0.28,2,3789,2652,714,1938,3248
clifford_simp_not_post_basic,8,5000,0.28,3,3823,2465,649,1816,3031
clifford_simp_not_post_basic,8,5000,0.28,4,3322,2529,681,1848,3113
clifford_simp_not_post_basic,8,5000,0.28,5,3643,2537,699,1838,3133
clifford_simp_not_post_basic,8,5000,0.32,1,3450,2597,747,1850,3220
clifford_simp_not_post_basic,8,5000,0.32,2,3345,2467,704,1763,3053
clifford_simp_not_post_basic,8,5000,0.32,3,3763,2638,703,1935,3232
clifford_simp_not_post_basic,8,5000,0.32,4,3573,2509,676,1833,3085
clifford_simp_not_post_basic,8,5000,0.32,5,3778,2614,742,1872,3233
clifford_simp_not_post_basic,8,5000,0.36,1,3121,2507,732,1775,3107
clifford_simp_not_post_basic,8,5000,0.36,2,3052,2437,710,1727,3019
clifford_simp_not_post_basic,8,5000,0.36,3,3285,2463,719,1744,3072
clifford_simp_not_post_basic,8,5000,0.36,4,3247,2451,729,1722,3059
clifford_simp_not_post_basic,8,5000,0.36,5,3094,2590,763,1827,3213
clifford_simp_not_post_basic,8,5000,0.4,1,3342,2566,754,1812,3185
clifford_simp_not_post_basic,8,5000,0.4,2,3209,2416,736,1680,3009
clifford_simp_not_post_basic,8,5000,0.4,3,3274,2378,716,1662,2980
clifford_simp_not_post_basic,8,5000,0.4,4,3434,2569,773,1796,3199
clifford_simp_not_post_basic,8,5000,0.4,5,3310,2465,757,1708,3083
clifford_simp_not_post_basic,8,8000,0.0,1,77,74,24,50,86
clifford_simp_not_post_basic,8,8000,0.0,2,63,67,21,46,79
clifford_simp_not_post_basic,8,8000,0.0,3,66,66,24,42,76
clifford_simp_not_post_basic,8,8000,0.0,4,71,66,23,43,79
clifford_simp_not_post_basic,8,8000,0.0,5,69,73,27,46,87
clifford_simp_not_post_basic,8,8000,0.04,1,6028,1336,263,1073,1588
clifford_simp_not_post_basic,8,8000,0.04,2,10863,1560,290,1270,1839
clifford_simp_not_post_basic,8,8000,0.04,3,7140,1557,294,1263,1839
clifford_simp_not_post_basic,8,8000,0.04,4,5717,1484,290,1194,1760
clifford_simp_not_post_basic,8,8000,0.04,5,7142,1490,288,1202,1760
clifford_simp_not_post_basic,8,8000,0.08,1,8198,2514,498,2016,2974
clifford_simp_not_post_basic,8,8000,0.08,2,8881,2744,563,2181,3267
clifford_simp_not_post_basic,8,8000,0.08,3,6152,2539,521,2018,3032
clifford_simp_not_post_basic,8,8000,0.08,4,6937,2556,516,2040,3043
clifford_simp_not_post_basic,8,8000,0.08,5,8619,2593,535,2058,3097
clifford_simp_not_post_basic,8,8000,0.12,1,6712,3171,699,2472,3803
clifford_simp_not_post_basic,8,8000,0.12,2,6397,3435,762,2673,4135
clifford_simp_not_post_basic,8,8000,0.12,3,6521,3199,707,2492,3852
clifford_simp_not_post_basic,8,8000,0.12,4,7985,3326,703,2623,3966
clifford_simp_not_post_basic,8,8000,0.12,5,7012,3290,725,2565,3953
clifford_simp_not_post_basic,8,8000,0.16,1,6154,3704,851,2853,4462
clifford_simp_not_post_basic,8,8000,0.16,2,6091,3919,923,2996,4739
clifford_simp_not_post_basic,8,8000,0.16,3,6813,3715,852,2863,4481
clifford_simp_not_post_basic,8,8000,0.16,4,7689,3893,902,2991,4699
clifford_simp_not_post_basic,8,8000,0.16,5,6270,3846,900,2946,4640
clifford_simp_not_post_basic,8,8000,0.2,1,6874,3992,960,3032,4835
clifford_simp_not_post_basic,8,8000,0.2,2,6147,3976,1007,2969,4861
clifford_simp_not_post_basic,8,8000,0.2,3,6469,3991,966,3025,4846
clifford_simp_not_post_basic,8,8000,0.2,4,6587,4007,950,3057,4842
clifford_simp_not_post_basic,8,8000,0.2,5,6391,4026,990,3036,4894
clifford_simp_not_post_basic,8,8000,0.24,1,6214,4192,1044,3148,5107
clifford_simp_not_post_basic,8,8000,0.24,2,5863,4047,1064,2983,4961
clifford_simp_not_post_basic,8,8000,0.24,3,6398,4114,1057,3057,5021
clifford_simp_not_post_basic,8,8000,0.24,4,6738,4134,1059,3075,5038
clifford_simp_not_post_basic,8,8000,0.24,5,6088,4148,1082,3066,5068
clifford_simp_not_post_basic,8,8000,0.28,1,5964,4216,1129,3087,5191
clifford_simp_not_post_basic,8,8000,0.28,2,6278,4221,1142,3079,5183
clifford_simp_not_post_basic,8,8000,0.28,3,6019,3949,1039,2910,4848
clifford_simp_not_post_basic,8,8000,0.28,4,5742,4009,1067,2942,4934
clifford_simp_not_post_basic,8,8000,0.28,5,6218,4177,1117,3060,5135
clifford_simp_not_post_basic,8,8000,0.32,1,5615,4097,1175,2922,5097
clifford_simp_not_post_basic,8,8000,0.32,2,5518,4068,1132,2936,5010
clifford_simp_not_post_basic,8,8000,0.32,3,5471,4052,1100,2952,4989
clifford_simp_not_post_basic,8,8000,0.32,4,5794,4091,1106,2985,5036
clifford_simp_not_post_basic,8,8000,0.32,5,6084,4167,1150,3017,5141
clifford_simp_not_post_basic,8,8000,0.36,1,5086,4031,1181,2850,5014
clifford_simp_not_post_basic,8,8000,0.36,2,5014,4017,1170,2847,4980
clifford_simp_not_post_basic,8,8000,0.36,3,5262,3930,1158,2772,4910
clifford_simp_not_post_basic,8,8000,0.36,4,5212,4038,1189,2849,5024
clifford_simp_not_post_basic,8,8000,0.36,5,5117,4183,1228,2955,5194
clifford_simp_not_post_basic,8,8000,0.4,1,5616,3987,1171,2816,4958
clifford_simp_not_post_basic,8,8000,0.4,2,5051,3906,1191,2715,4881
clifford_simp_not_post_basic,8,8000,0.4,3,5064,3865,1165,2700,4838
clifford_simp_not_post_basic,8,8000,0.4,4,5133,4047,1226,2821,5046
clifford_simp_not_post_basic,8,8000,0.4,5,5632,4153,1222,2931,5149
clifford_simp_not_post_basic,8,10000,0.0,1,74,66,22,44,78
clifford_simp_not_post_basic,8,10000,0.0,2,70,70,23,47,83
clifford_simp_not_post_basic,8,10000,0.0,3,75,72,26,46,84
clifford_simp_not_post_basic,8,10000,0.0,4,62,63,23,40,75
clifford_simp_not_post_basic,8,10000,0.0,5,64,59,20,39,72
clifford_simp_not_post_basic,8,10000,0.04,1,10265,1710,331,1379,2030
clifford_simp_not_post_basic,8,10000,0.04,2,10855,1975,367,1608,2324
clifford_simp_not_post_basic,8,10000,0.04,3,7546,1813,345,1468,2144
clifford_simp_not_post_basic,8,10000,0.04,4,7332,1884,361,1523,2229
clifford_simp_not_post_basic,8,10000,0.04,5,8847,1818,348,1470,2147
clifford_simp_not_post_basic,8,10000,0.08,1,9369,3169,636,2533,3763
clifford_simp_not_post_basic,8,10000,0.08,2,12803,3370,687,2683,4017
clifford_simp_not_post_basic,8,10000,0.08,3,8074,3177,640,2537,3778
clifford_simp_not_post_basic,8,10000,0.08,4,8155,3078,623,2455,3659
clifford_simp_not_post_basic,8,10000,0.08,5,10761,3267,653,2614,3886
clifford_simp_not_post_basic,8,10000,0.12,1,8144,4084,887,3197,4888
clifford_simp_not_post_basic,8,10000,0.12,2,8191,4267,944,3323,5138
clifford_simp_not_post_basic,8,10000,0.12,3,8143,3983,863,3120,4785
clifford_simp_not_post_basic,8,10000,0.12,4,9666,4104,860,3244,4892
clifford_simp_not_post_basic,8,10000,0.12,5,8591,4052,891,3161,4864
clifford_simp_not_post_basic,8,10000,0.16,1,8297,4653,1069,3584,5598
clifford_simp_not_post_basic,8,10000,0.16,2,8030,4897,1147,3750,5919
clifford_simp_not_post_basic,8,10000,0.16,3,8222,4605,1047,3558,5553
clifford_simp_not_post_basic,8,10000,0.16,4,8951,4757,1087,3670,5735
clifford_simp_not_post_basic,8,10000,0.16,5,7879,4724,1107,3617,5705
clifford_simp_not_post_basic,8,10000,0.2,1,8153,5043,1196,3847,6101
clifford_simp_not_post_basic,8,10000,0.2,2,8025,5009,1252,3757,6111
clifford_simp_not_post_basic,8,10000,0.2,3,8592,4961,1167,3794,5993
clifford_simp_not_post_basic,8,10000,0.2,4,8500,4945,1173,3772,5989
clifford_simp_not_post_basic,8,10000,0.2,5,8211,5080,1253,3827,6169
clifford_simp_not_post_basic,8,10000,0.24,1,7867,5210,1313,3897,6358
clifford_simp_not_post_basic,8,10000,0.24,2,7287,5022,1312,3710,6154
clifford_simp_not_post_basic,8,10000,0.24,3,7969,5173,1302,3871,6298
clifford_simp_not_post_basic,8,10000,0.24,4,8116,5118,1316,3802,6246
clifford_simp_not_post_basic,8,10000,0.24,5,7205,5109,1319,3790,6232
clifford_simp_not_post_basic,8,10000,0.28,1,7195,5189,1393,3796,6378
clifford_simp_not_post_basic,8,10000,0.28,2,7678,5276,1413,3863,6462
clifford_simp_not_post_basic,8,10000,0.28,3,7646,4987,1297,3690,6116
clifford_simp_not_post_basic,8,10000,0.28,4,6988,4992,1352,3640,6162
clifford_simp_not_post_basic,8,10000,0.28,5,7277,5134,1367,3767,6311
clifford_simp_not_post_basic,8,10000,0.32,1,7142,5144,1448,3696,6375
clifford_simp_not_post_basic,8,10000,0.32,2,6793,5037,1392,3645,6205
clifford_simp_not_post_basic,8,10000,0.32,3,7510,5150,1383,3767,6330
clifford_simp_not_post_basic,8,10000,0.32,4,7012,5144,1391,3753,6331
clifford_simp_not_post_basic,8,10000,0.32,5,7634,5231,1436,3795,6446
clifford_simp_not_post_basic,8,10000,0.36,1,6632,5048,1474,3574,6285
clifford_simp_not_post_basic,8,10000,0.36,2,6907,5031,1433,3598,6217
clifford_simp_not_post_basic,8,10000,0.36,3,6686,4973,1435,3538,6186
clifford_simp_not_post_basic,8,10000,0.36,4,6464,5008,1476,3532,6236
clifford_simp_not_post_basic,8,10000,0.36,5,6586,5204,1510,3694,6449
clifford_simp_not_post_basic,8,10000,0.4,1,7172,4921,1446,3475,6125
clifford_simp_not_post_basic,8,10000,0.4,2,6597,4824,1456,3368,6028
clifford_simp_not_post_basic,8,10000,0.4,3,6621,4900,1441,3459,6108
clifford_simp_not_post_basic,8,10000,0.4,4,6612,5057,1507,3550,6295
clifford_simp_not_post_basic,8,10000,0.4,5,6765,5066,1505,3561,6299
clifford_simp_not_post_basic,16,100,0.0,1,179,154,44,110,177
clifford_simp_not_post_basic,16,100,0.0,2,125,127,43,84,153
clifford_simp_not_post_basic,16,100,0.0,3,124,123,43,80,142
clifford_simp_not_post_basic,16,100,0.0,4,146,139,35,104,162
clifford_simp_not_post_basic,16,100,0.0,5,136,135,48,87,157
clifford_simp_not_post_basic,16,100,0.04,1,195,171,47,124,193
clifford_simp_not_post_basic,16,100,0.04,2,106,108,43,65,135
clifford_simp_not_post_basic,16,100,0.04,3,108,105,36,69,124
clifford_simp_not_post_basic,16,100,0.04,4,176,154,40,114,170
clifford_simp_not_post_basic,16,100,0.04,5,126,124,41,83,143
clifford_simp_not_post_basic,16,100,0.08,1,143,146,46,100,171
clifford_simp_not_post_basic,16,100,0.08,2,90,102,50,52,131
clifford_simp_not_post_basic,16,100,0.08,3,109,109,37,72,125
clifford_simp_not_post_basic,16,100,0.08,4,171,156,39,117,180
clifford_simp_not_post_basic,16,100,0.08,5,103,108,42,66,133
clifford_simp_not_post_basic,16,100,0.12,1,104,118,48,70,142
clifford_simp_not_post_basic,16,100,0.12,2,84,92,42,50,119
clifford_simp_not_post_basic,16,100,0.12,3,121,117,41,76,140
clifford_simp_not_post_basic,16,100,0.12,4,117,124,45,79,146
clifford_simp_not_post_basic,16,100,0.12,5,131,127,40,87,153
clifford_simp_not_post_basic,16,100,0.16,1,126,129,50,79,156
clifford_simp_not_post_basic,16,100,0.16,2,97,100,43,57,129
clifford_simp_not_post_basic,16,100,0.16,3,79,84,43,41,108
clifford_simp_not_post_basic,16,100,0.16,4,125,113,43,70,136
clifford_simp_not_post_basic,16,100,0.16,5,121,125,41,84,156
clifford_simp_not_post_basic,16,100,0.2,1,98,111,50,61,134
clifford_simp_not_post_basic,16,100,0.2,2,117,117,45,72,143
clifford_simp_not_post_basic,16,100,0.2,3,80,85,45,40,110
clifford_simp_not_post_basic,16,100,0.2,4,115,115,43,72,142
clifford_simp_not_post_basic,16,100,0.2,5,155,154,46,108,182
clifford_simp_not_post_basic,16,100,0.24,1,93,105,46,59,127
clifford_simp_not_post_basic,16,100,0.24,2,81,88,45,43,110
clifford_simp_not_post_basic,16,100,0.24,3,77,80,39,41,103
clifford_simp_not_post_basic,16,100,0.24,4,93,91,38,53,114
clifford_simp_not_post_basic,16,100,0.24,5,96,115,48,67,142
clifford_simp_not_post_basic,16,100,0.28,1,121,136,52,84,162
clifford_simp_not_post_basic,16,100,0.28,2,92,101,52,49,123
clifford_simp_not_post_basic,16,100,0.28,3,75,79,37,42,101
clifford_simp_not_post_basic,16,100,0.28,4,127,120,46,74,151
clifford_simp_not_post_basic,16,100,0.28,5,94,108,45,63,135
clifford_simp_not_post_basic,16,100,0.32,1,101,106,46,60,131
clifford_simp_not_post_basic,16,100,0.32,2,89,98,50,48,121
clifford_simp_not_post_basic,16,100,0.32,3,77,84,38,46,108
clifford_simp_not_post_basic,16,100,0.32,4,79,87,47,40,116
clifford_simp_not_post_basic,16,100,0.32,5,78,92,47,45,116
clifford_simp_not_post_basic,16,100,0.36,1,75,79,40,39,101
clifford_simp_not_post_basic,16,100,0.36,2,90,95,47,48,118
clifford_simp_not_post_basic,16,100,0.36,3,70,78,37,41,102
clifford_simp_not_post_basic,16,100,0.36,4,71,77,40,37,106
clifford_simp_not_post_basic,16,100,0.36,5,74,76,37,39,100
clifford_simp_not_post_basic,16,100,0.4,1,61,63,37,26,87
clifford_simp_not_post_basic,16,100,0.4,2,72,80,44,36,103
clifford_simp_not_post_basic,16,100,0.4,3,74,78,36,42,100
clifford_simp_not_post_basic,16,100,0.4,4,67,74,36,38,101
clifford_simp_not_post_basic,16,100,0.4,5,77,83,42,41,107
clifford_simp_not_post_basic,16,1000,0.0,1,269,222,47,175,246
clifford_simp_not_post_basic,16,1000,0.0,2,245,200,43,157,223
clifford_simp_not_post_basic,16,1000,0.0,3,272,212,43,169,233
clifford_simp_not_post_basic,16,1000,0.0,4,246,200,48,152,222
clifford_simp_not_post_basic,16,1000,0.0,5,252,209,47,162,231
clifford_simp_not_post_basic,16,1000,0.04,1,791,476,72,404,524
clifford_simp_not_post_basic,16,1000,0.04,2,884,500,84,416,558
clifford_simp_not_post_basic,16,1000,0.04,3,858,501,79,422,556
clifford_simp_not_post_basic,16,1000,0.04,4,864,497,72,425,554
clifford_simp_not_post_basic,16,1000,0.04,5,951,510,78,432,564
clifford_simp_not_post_basic,16,1000,0.08,1,1248,613,91,522,682
clifford_simp_not_post_basic,16,1000,0.08,2,1252,663,107,556,746
clifford_simp_not_post_basic,16,1000,0.08,3,1378,713,107,606,795
clifford_simp_not_post_basic,16,1000,0.08,4,1605,715,103,612,795
clifford_simp_not_post_basic,16,1000,0.08,5,1415,649,95,554,725
clifford_simp_not_post_basic,16,1000,0.12,1,1760,813,125,688,907
clifford_simp_not_post_basic,16,1000,0.12,2,1853,804,126,678,908
clifford_simp_not_post_basic,16,1000,0.12,3,1163,739,122,617,833
clifford_simp_not_post_basic,16,1000,0.12,4,1588,844,136,708,948
clifford_simp_not_post_basic,16,1000,0.12,5,1886,819,123,696,916
clifford_simp_not_post_basic,16,1000,0.16,1,1473,888,155,733,1008
clifford_simp_not_post_basic,16,1000,0.16,2,1542,890,143,747,1003
clifford_simp_not_post_basic,16,1000,0.16,3,1226,746,120,626,848
clifford_simp_not_post_basic,16,1000,0.16,4,1326,905,169,736,1039
clifford_simp_not_post_basic,16,1000,0.16,5,2191,871,138,733,981
clifford_simp_not_post_basic,16,1000,0.2,1,1285,843,166,677,971
clifford_simp_not_post_basic,16,1000,0.2,2,1354,813,159,654,933
clifford_simp_not_post_basic,16,1000,0.2,3,1048,823,152,671,947
clifford_simp_not_post_basic,16,1000,0.2,4,1417,905,182,723,1038
clifford_simp_not_post_basic,16,1000,0.2,5,2038,937,150,787,1054
clifford_simp_not_post_basic,16,1000,0.24,1,1219,892,171,721,1020
clifford_simp_not_post_basic,16,1000,0.24,2,1242,824,163,661,949
clifford_simp_not_post_basic,16,1000,0.24,3,1261,810,148,662,924
clifford_simp_not_post_basic,16,1000,0.24,4,1394,866,183,683,1004
clifford_simp_not_post_basic,16,1000,0.24,5,1565,914,160,754,1042
clifford_simp_not_post_basic,16,1000,0.28,1,1818,872,171,701,1000
clifford_simp_not_post_basic,16,1000,0.28,2,1665,817,166,651,956
clifford_simp_not_post_basic,16,1000,0.28,3,1024,757,156,601,869
clifford_simp_not_post_basic,16,1000,0.28,4,1173,870,197,673,1019
clifford_simp_not_post_basic,16,1000,0.28,5,1357,874,166,708,1006
clifford_simp_not_post_basic,16,1000,0.32,1,1328,862,188,674,997
clifford_simp_not_post_basic,16,1000,0.32,2,1334,810,177,633,948
clifford_simp_not_post_basic,16,1000,0.32,3,1210,819,156,663,939
clifford_simp_not_post_basic,16,1000,0.32,4,1569,967,178,789,1106
clifford_simp_not_post_basic,16,1000,0.32,5,1017,771,176,595,904
clifford_simp_not_post_basic,16,1000,0.36,1,1271,838,188,650,974
clifford_simp_not_post_basic,16,1000,0.36,2,1061,789,160,629,916
clifford_simp_not_post_basic,16,1000,0.36,3,1314,771,155,616,895
clifford_simp_not_post_basic,16,1000,0.36,4,1074,832,180,652,972
clifford_simp_not_post_basic,16,1000,0.36,5,1793,965,172,793,1102
clifford_simp_not_post_basic,16,1000,0.4,1,808,718,178,540,852
clifford_simp_not_post_basic,16,1000,0.4,2,832,629,162,467,754
clifford_simp_not_post_basic,16,1000,0.4,3,1063,730,168,562,854
clifford_simp_not_post_basic,16,1000,0.4,4,1343,875,184,691,1012
clifford_simp_not_post_basic,16,1000,0.4,5,1187,867,163,704,998
clifford_simp_not_post_basic,16,3000,0.0,1,281,230,52,178,257
clifford_simp_not_post_basic,16,3000,0.0,2,269,219,48,171,238
clifford_simp_not_post_basic,16,3000,0.0,3,267,216,46,170,237
clifford_simp_not_post_basic,16,3000,0.0,4,279,227,56,171,249
clifford_simp_not_post_basic,16,3000,0.0,5,250,218,52,166,244
clifford_simp_not_post_basic,16,3000,0.04,1,3508,1136,138,998,1249
clifford_simp_not_post_basic,16,3000,0.04,2,4028,1222,149,1073,1345
clifford_simp_not_post_basic,16,3000,0.04,3,4429,1281,158,1123,1414
clifford_simp_not_post_basic,16,3000,0.04,4,3857,1189,143,1046,1310
clifford_simp_not_post_basic,16,3000,0.04,5,3542,1123,136,987,1241
clifford_simp_not_post_basic,16,3000,0.08,1,8106,1811,216,1595,2000
clifford_simp_not_post_basic,16,3000,0.08,2,6547,1970,238,1732,2182
clifford_simp_not_post_basic,16,3000,0.08,3,9386,2024,249,1775,2237
clifford_simp_not_post_basic,16,3000,0.08,4,9495,1983,234,1749,2185
clifford_simp_not_post_basic,16,3000,0.08,5,7672,1929,229,1700,2129
clifford_simp_not_post_basic,16,3000,0.12,1,9008,2320,298,2022,2577
clifford_simp_not_post_basic,16,3000,0.12,2,5531,2327,315,2012,2600
clifford_simp_not_post_basic,16,3000,0.12,3,7686,2151,284,1867,2400
clifford_simp_not_post_basic,16,3000,0.12,4,8735,2262,294,1968,2515
clifford_simp_not_post_basic,16,3000,0.12,5,8661,2291,297,1994,2547
clifford_simp_not_post_basic,16,3000,0.16,1,7284,2696,375,2321,3016
clifford_simp_not_post_basic,16,3000,0.16,2,5416,2574,368,2206,2887
clifford_simp_not_post_basic,16,3000,0.16,3,6483,2385,327,2058,2674
clifford_simp_not_post_basic,16,3000,0.16,4,7446,2472,360,2112,2781
clifford_simp_not_post_basic,16,3000,0.16,5,6746,2446,329,2117,2736
clifford_simp_not_post_basic,16,3000,0.2,1,5359,2553,420,2133,2907
clifford_simp_not_post_basic,16,3000,0.2,2,7797,2543,394,2149,2869
clifford_simp_not_post_basic,16,3000,0.2,3,3619,2383,422,1961,2737
clifford_simp_not_post_basic,16,3000,0.2,4,5054,2542,403,2139,2884
clifford_simp_not_post_basic,16,3000,0.2,5,6974,2479,355,2124,2785
clifford_simp_not_post_basic,16,3000,0.24,1,4566,2597,432,2165,2950
clifford_simp_not_post_basic,16,3000,0.24,2,5485,2655,421,2234,3006
clifford_simp_not_post_basic,16,3000,0.24,3,4995,2560,452,2108,2935
clifford_simp_not_post_basic,16,3000,0.24,4,4153,2536,456,2080,2913
clifford_simp_not_post_basic,16,3000,0.24,5,4622,2480,411,2069,2825
clifford_simp_not_post_basic,16,3000,0.28,1,4459,2487,446,2041,2859
clifford_simp_not_post_basic,16,3000,0.28,2,4072,2480,466,2014,2858
clifford_simp_not_post_basic,16,3000,0.28,3,3391,2235,441,1794,2596
clifford_simp_not_post_basic,16,3000,0.28,4,3315,2367,491,1876,2761
clifford_simp_not_post_basic,16,3000,0.28,5,3894,2411,423,1988,2768
clifford_simp_not_post_basic,16,3000,0.32,1,3349,2325,497,1828,2727
clifford_simp_not_post_basic,16,3000,0.32,2,3598,2397,474,1923,2778
clifford_simp_not_post_basic,16,3000,0.32,3,3092,2219,447,1772,2587
clifford_simp_not_post_basic,16,3000,0.32,4,3585,2460,479,1981,2849
clifford_simp_not_post_basic,16,3000,0.32,5,3559,2291,423,1868,2639
clifford_simp_not_post_basic,16,3000,0.36,1,3089,2093,460,1633,2454
clifford_simp_not_post_basic,16,3000,0.36,2,3504,2372,462,1910,2756
clifford_simp_not_post_basic,16,3000,0.36,3,3014,2066,440,1626,2428
clifford_simp_not_post_basic,16,3000,0.36,4,3133,2225,489,1736,2622
clifford_simp_not_post_basic,16,3000,0.36,5,3447,2201,432,1769,2556
clifford_simp_not_post_basic,16,3000,0.4,1,2770,2110,437,1673,2462
clifford_simp_not_post_basic,16,3000,0.4,2,2967,2179,458,1721,2553
clifford_simp_not_post_basic,16,3000,0.4,3,2543,1964,471,1493,2334
clifford_simp_not_post_basic,16,3000,0.4,4,3136,2253,496,1757,2646
clifford_simp_not_post_basic,16,3000,0.4,5,2775,2174,474,1700,2554
clifford_simp_not_post_basic,16,5000,0.0,1,267,221,50,171,246
clifford_simp_not_post_basic,16,5000,0.0,2,279,228,51,177,251
clifford_simp_not_post_basic,16,5000,0.0,3,252,207,46,161,232
clifford_simp_not_post_basic,16,5000,0.0,4,278,215,47,168,236
clifford_simp_not_post_basic,16,5000,0.0,5,265,228,51,177,252
clifford_simp_not_post_basic,16,5000,0.04,1,7887,1764,200,1564,1938
clifford_simp_not_post_basic,16,5000,0.04,2,9103,1906,219,1687,2093
clifford_simp_not_post_basic,16,5000,0.04,3,10326,2087,223,1864,2281
clifford_simp_not_post_basic,16,5000,0.04,4,9581,1981,216,1765,2174
clifford_simp_not_post_basic,16,5000,0.04,5,8887,1889,215,1674,2068
clifford_simp_not_post_basic,16,5000,0.08,1,16092,2921,331,2590,3223
clifford_simp_not_post_basic,16,5000,0.08,2,15158,3111,355,2756,3440
clifford_simp_not_post_basic,16,5000,0.08,3,16822,3282,382,2900,3626
clifford_simp_not_post_basic,16,5000,0.08,4,21774,3144,355,2789,3473
clifford_simp_not_post_basic,16,5000,0.08,5,17022,3086,350,2736,3412
clifford_simp_not_post_basic,16,5000,0.12,1,17444,3641,453,3188,4047
clifford_simp_not_post_basic,16,5000,0.12,2,10066,3753,491,3262,4201
clifford_simp_not_post_basic,16,5000,0.12,3,20077,3667,447,3220,4075
clifford_simp_not_post_basic,16,5000,0.12,4,18117,3856,485,3371,4293
clifford_simp_not_post_basic,16,5000,0.12,5,18076,3773,476,3297,4204
clifford_simp_not_post_basic,16,5000,0.16,1,11618,4110,548,3562,4590
clifford_simp_not_post_basic,16,5000,0.16,2,8364,4067,595,3472,4589
clifford_simp_not_post_basic,16,5000,0.16,3,8675,3998,544,3454,4483
clifford_simp_not_post_basic,16,5000,0.16,4,11865,4207,594,3613,4730
clifford_simp_not_post_basic,16,5000,0.16,5,12631,4239,556,3683,4731
clifford_simp_not_post_basic,16,5000,0.2,1,9942,4149,621,3528,4681
clifford_simp_not_post_basic,16,5000,0.2,2,12047,4174,647,3527,4721
clifford_simp_not_post_basic,16,5000,0.2,3,7974,4196,664,3532,4770
clifford_simp_not_post_basic,16,5000,0.2,4,9002,4155,644,3511,4708
clifford_simp_not_post_basic,16,5000,0.2,5,12061,4241,609,3632,4777
clifford_simp_not_post_basic,16,5000,0.24,1,10326,4332,649,3683,4892
clifford_simp_not_post_basic,16,5000,0.24,2,8550,4130,677,3453,4698
clifford_simp_not_post_basic,16,5000,0.24,3,8071,4205,711,3494,4800
clifford_simp_not_post_basic,16,5000,0.24,4,8294,4154,704,3450,4752
clifford_simp_not_post_basic,16,5000,0.24,5,8637,4186,702,3484,4778
clifford_simp_not_post_basic,16,5000,0.28,1,7242,3975,685,3290,4559
clifford_simp_not_post_basic,16,5000,0.28,2,6633,4037,705,3332,4632
clifford_simp_not_post_basic,16,5000,0.28,3,8323,3953,719,3234,4557
clifford_simp_not_post_basic,16,5000,0.28,4,5786,3885,759,3126,4514
clifford_simp_not_post_basic,16,5000,0.28,5,9329,4312,743,3569,4930
clifford_simp_not_post_basic,16,5000,0.32,1,5992,3816,743,3073,4430
clifford_simp_not_post_basic,16,5000,0.32,2,5619,3840,760,3080,4469
clifford_simp_not_post_basic,16,5000,0.32,3,6447,4010,756,3254,4634
clifford_simp_not_post_basic,16,5000,0.32,4,5915,3977,760,3217,4610
clifford_simp_not_post_basic,16,5000,0.32,5,6103,4010,751,3259,4618
clifford_simp_not_post_basic,16,5000,0.36,1,5337,3624,731,2893,4224
clifford_simp_not_post_basic,16,5000,0.36,2,5423,3756,788,2968,4386
clifford_simp_not_post_basic,16,5000,0.36,3,5997,3606,732,2874,4215
clifford_simp_not_post_basic,16,5000,0.36,4,5318,3793,789,3004,4432
clifford_simp_not_post_basic,16,5000,0.36,5,6246,3809,753,3056,4427
clifford_simp_not_post_basic,16,5000,0.4,1,4301,3380,724,2656,3966
clifford_simp_not_post_basic,16,5000,0.4,2,4781,3468,750,2718,4083
clifford_simp_not_post_basic,16,5000,0.4,3,4751,3468,753,2715,4081
clifford_simp_not_post_basic,16,5000,0.4,4,5232,3619,794,2825,4251
clifford_simp_not_post_basic,16,5000,0.4,5,6018,3623,772,2851,4242
clifford_simp_not_post_basic,16,8000,0.0,1,245,215,49,166,243
clifford_simp_not_post_basic,16,8000,0.0,2,250,197,45,152,224
clifford_simp_not_post_basic,16,8000,0.0,3,269,213,42,171,236
clifford_simp_not_post_basic,16,8000,0.0,4,250,212,50,162,237
clifford_simp_not_post_basic,16,8000,0.0,5,252,216,50,166,242
clifford_simp_not_post_basic,16,8000,0.04,1,18874,2845,292,2553,3111
clifford_simp_not_post_basic,16,8000,0.04,2,21230,3029,322,2707,3321
clifford_simp_not_post_basic,16,8000,0.04,3,21689,3116,333,2783,3416
clifford_simp_not_post_basic,16,8000,0.04,4,21390,3066,318,2748,3356
clifford_simp_not_post_basic,16,8000,0.04,5,19926,2981,311,2670,3265
clifford_simp_not_post_basic,16,8000,0.08,1,27082,4706,516,4190,5184
clifford_simp_not_post_basic,16,8000,0.08,2,26934,5020,553,4467,5539
clifford_simp_not_post_basic,16,8000,0.08,3,27106,4766,547,4219,5274
clifford_simp_not_post_basic,16,8000,0.08,4,33755,4888,535,4353,5380
clifford_simp_not_post_basic,16,8000,0.08,5,24402,4990,550,4440,5510
clifford_simp_not_post_basic,16,8000,0.12,1,24266,5718,682,5036,6346
clifford_simp_not_post_basic,16,8000,0.12,2,15004,6012,749,5263,6702
clifford_simp_not_post_basic,16,8000,0.12,3,33834,5784,691,5093,6426
clifford_simp_not_post_basic,16,8000,0.12,4,28289,6082,730,5352,6740
clifford_simp_not_post_basic,16,8000,0.12,5,22335,6056,738,5318,6729
clifford_simp_not_post_basic,16,8000,0.16,1,19637,6393,838,5555,7140
clifford_simp_not_post_basic,16,8000,0.16,2,13331,6646,927,5719,7464
clifford_simp_not_post_basic,16,8000,0.16,3,15581,6410,832,5578,7163
clifford_simp_not_post_basic,16,8000,0.16,4,17193,6638,920,5718,7460
clifford_simp_not_post_basic,16,8000,0.16,5,18751,6526,864,5662,7301
clifford_simp_not_post_basic,16,8000,0.2,1,14193,6517,959,5558,7360
clifford_simp_not_post_basic,16,8000,0.2,2,17916,6832,1027,5805,7715
clifford_simp_not_post_basic,16,8000,0.2,3,12153,6404,1019,5385,7279
clifford_simp_not_post_basic,16,8000,0.2,4,15741,6681,984,5697,7538
clifford_simp_not_post_basic,16,8000,0.2,5,18761,6929,971,5958,7786
clifford_simp_not_post_basic,16,8000,0.24,1,14662,6755,1039,5716,7645
clifford_simp_not_post_basic,16,8000,0.24,2,13095,6772,1118,5654,7712
clifford_simp_not_post_basic,16,8000,0.24,3,12292,6718,1094,5624,7646
clifford_simp_not_post_basic,16,8000,0.24,4,12211,6530,1057,5473,7443
clifford_simp_not_post_basic,16,8000,0.24,5,11739,6703,1096,5607,7649
clifford_simp_not_post_basic,16,8000,0.28,1,10466,6228,1090,5138,7162
clifford_simp_not_post_basic,16,8000,0.28,2,11405,6601,1159,5442,7577
clifford_simp_not_post_basic,16,8000,0.28,3,11248,6287,1110,5177,7227
clifford_simp_not_post_basic,16,8000,0.28,4,10094,6442,1158,5284,7420
clifford_simp_not_post_basic,16,8000,0.28,5,13676,6744,1144,5600,7732
clifford_simp_not_post_basic,16,8000,0.32,1,9266,5964,1182,4782,6949
clifford_simp_not_post_basic,16,8000,0.32,2,9482,6139,1170,4969,7122
clifford_simp_not_post_basic,16,8000,0.32,3,9245,6165,1179,4986,7139
clifford_simp_not_post_basic,16,8000,0.32,4,10258,6443,1196,5247,7440
clifford_simp_not_post_basic,16,8000,0.32,5,11096,6477,1193,5284,7462
clifford_simp_not_post_basic,16,8000,0.36,1,9702,5793,1167,4626,6749
clifford_simp_not_post_basic,16,8000,0.36,2,8919,5929,1210,4719,6929
clifford_simp_not_post_basic,16,8000,0.36,3,8475,5483,1161,4322,6453
clifford_simp_not_post_basic,16,8000,0.36,4,8492,5927,1246,4681,6963
clifford_simp_not_post_basic,16,8000,0.36,5,10141,6166,1232,4934,7178
clifford_simp_not_post_basic,16,8000,0.4,1,7875,5429,1143,4286,6359
clifford_simp_not_post_basic,16,8000,0.4,2,8338,5643,1194,4449,6632
clifford_simp_not_post_basic,16,8000,0.4,3,7204,5297,1172,4125,6256
clifford_simp_not_post_basic,16,8000,0.4,4,7987,5860,1279,4581,6885
clifford_simp_not_post_basic,16,8000,0.4,5,8889,5770,1214,4556,6767
clifford_simp_not_post_basic,16,10000,0.0,1,281,215,48,167,243
clifford_simp_not_post_basic,16,10000,0.0,2,247,214,45,169,240
clifford_simp_not_post_basic,16,10000,0.0,3,278,222,47,175,248
clifford_simp_not_post_basic,16,10000,0.0,4,245,203,51,152,229
clifford_simp_not_post_basic,16,10000,0.0,5,263,227,52,175,256
clifford_simp_not_post_basic,16,10000,0.04,1,27494,3512,354,3158,3842
clifford_simp_not_post_basic,16,10000,0.04,2,30694,3728,378,3350,4085
clifford_simp_not_post_basic,16,10000,0.04,3,31111,3722,383,3339,4074
clifford_simp_not_post_basic,16,10000,0.04,4,31283,3765,392,3373,4126
clifford_simp_not_post_basic,16,10000,0.04,5,30045,3649,372,3277,3991
clifford_simp_not_post_basic,16,10000,0.08,1,37019,5785,625,5160,6374
clifford_simp_not_post_basic,16,10000,0.08,2,40444,6041,662,5379,6677
clifford_simp_not_post_basic,16,10000,0.08,3,39749,6008,666,5342,6632
clifford_simp_not_post_basic,16,10000,0.08,4,40025,5919,651,5268,6521
clifford_simp_not_post_basic,16,10000,0.08,5,34515,6180,677,5503,6816
clifford_simp_not_post_basic,16,10000,0.12,1,32578,7262,858,6404,8057
clifford_simp_not_post_basic,16,10000,0.12,2,21134,7508,928,6580,8358
clifford_simp_not_post_basic,16,10000,0.12,3,39389,7257,862,6395,8060
clifford_simp_not_post_basic,16,10000,0.12,4,38311,7485,882,6603,8296
clifford_simp_not_post_basic,16,10000,0.12,5,29006,7429,896,6533,8250
clifford_simp_not_post_basic,16,10000,0.16,1,26264,8052,1044,7008,8988
clifford_simp_not_post_basic,16,10000,0.16,2,18721,8206,1130,7076,9217
clifford_simp_not_post_basic,16,10000,0.16,3,21349,8034,1052,6982,8984
clifford_simp_not_post_basic,16,10000,0.16,4,25447,8497,1126,7371,9500
clifford_simp_not_post_basic,16,10000,0.16,5,20637,8045,1055,6990,9000
clifford_simp_not_post_basic,16,10000,0.2,1,19100,8419,1203,7216,9472
clifford_simp_not_post_basic,16,10000,0.2,2,22628,8498,1251,7247,9591
clifford_simp_not_post_basic,16,10000,0.2,3,16031,8242,1265,6977,9339
clifford_simp_not_post_basic,16,10000,0.2,4,20745,8493,1209,7284,9556
clifford_simp_not_post_basic,16,10000,0.2,5,21135,8418,1200,7218,9481
clifford_simp_not_post_basic,16,10000,0.24,1,17353,8231,1291,6940,9355
clifford_simp_not_post_basic,16,10000,0.24,2,15478,8352,1390,6962,9538
clifford_simp_not_post_basic,16,10000,0.24,3,16049,8399,1366,7033,9571
clifford_simp_not_post_basic,16,10000,0.24,4,15828,8290,1328,6962,9440
clifford_simp_not_post_basic,16,10000,0.24,5,15131,8327,1361,6966,9501
clifford_simp_not_post_basic,16,10000,0.28,1,14956,7863,1353,6510,9023
clifford_simp_not_post_basic,16,10000,0.28,2,13795,8094,1438,6656,9314
clifford_simp_not_post_basic,16,10000,0.28,3,13869,8023,1429,6594,9237
clifford_simp_not_post_basic,16,10000,0.28,4,13475,8098,1456,6642,9319
clifford_simp_not_post_basic,16,10000,0.28,5,14966,8146,1429,6717,9368
clifford_simp_not_post_basic,16,10000,0.32,1,11735,7532,1438,6094,8738
clifford_simp_not_post_basic,16,10000,0.32,2,12715,7705,1456,6249,8933
clifford_simp_not_post_basic,16,10000,0.32,3,11058,7586,1499,6087,8834
clifford_simp_not_post_basic,16,10000,0.32,4,12280,8021,1483,6538,9256
clifford_simp_not_post_basic,16,10000,0.32,5,12896,7829,1482,6347,9057
clifford_simp_not_post_basic,16,10000,0.36,1,13265,7493,1400,6093,8674
clifford_simp_not_post_basic,16,10000,0.36,2,11295,7427,1502,5925,8675
clifford_simp_not_post_basic,16,10000,0.36,3,10620,7112,1485,5627,8357
clifford_simp_not_post_basic,16,10000,0.36,4,10709,7438,1538,5900,8702
clifford_simp_not_post_basic,16,10000,0.36,5,12439,7593,1507,6086,8839
clifford_simp_not_post_basic,16,10000,0.4,1,9324,6734,1416,5318,7902
clifford_simp_not_post_basic,16,10000,0.4,2,11145,7114,1502,5612,8360
clifford_simp_not_post_basic,16,10000,0.4,3,9212,6586,1512,5074,7824
clifford_simp_not_post_basic,16,10000,0.4,4,10471,7322,1585,5737,8593
clifford_simp_not_post_basic,16,10000,0.4,5,10981,7240,1511,5729,8478
